candidate,cap,substring-cap,s-o-sCap,all-cap,non-cap,non-discriminative,cumulative,status
meals on wheels,2,2,0,0,1,0,5,a
agreed,2,0,2,1,2,2,9,a
republican,12,0,4,0,7,6,29,a
nazi death camps,3,5,0,0,0,0,8,a
senator,2,0,0,0,2,1,5,a
senators,2,0,0,0,2,1,5,a
ww1,0,0,0,4,1,0,5,a
devil,3,0,0,0,2,0,5,a
syria strike proves,11,9,0,0,0,6,26,a
clearance,1,0,0,0,1,2,4,a
apparently hitler,1,2,0,0,0,0,3,a
adminstration,2,0,0,0,2,0,4,a
bingo,3,0,0,0,3,0,6,a
thereγçös,1,2,1,0,0,0,4,a
hitler comparison,1,2,0,0,0,0,3,a
attack on syria,2,2,0,0,0,0,4,a
syria strike,18,48,0,0,0,6,72,a
united ceo oscar munoz,3,0,0,1,0,1,5,a
trump told,1,3,0,0,0,0,4,a
god,56,0,13,2,60,49,180,a
easter egg,0,1,0,0,0,5,6,a
whites,2,0,0,0,1,2,5,a
russia ties,11,29,0,0,1,7,48,a
sean spicer draws backlash,49,0,0,0,0,24,73,a
literally hitler,1,7,0,1,0,8,17,a
sob,1,0,0,2,2,1,6,a
press secretary sean spicer,48,11,0,0,0,9,68,a
ice,0,0,0,4,2,0,6,a
measured,2,0,0,0,2,0,4,a
eric trump admits,4,4,0,0,0,2,10,a
bye bye,2,1,0,0,1,3,7,a
geez,1,0,5,0,0,1,7,a
reaccomodated,2,0,0,0,2,0,4,a
pepsi ad,1,2,0,0,0,1,4,a
cillizza,8,0,18,0,0,0,26,a
soldier,3,0,0,0,2,0,5,a
missile strike in syria,5,2,0,0,0,1,8,a
don the con,3,3,0,1,0,0,7,a
big win,1,0,0,0,1,3,5,a
daughter ivanka,2,3,0,0,0,4,9,a
pops,2,0,0,0,2,0,4,a
orchestrated,2,0,0,0,2,0,4,a
your fired,1,0,0,0,1,1,3,a
sean spicer's false claim,2,0,0,0,0,1,3,a
woah,1,0,1,0,0,3,5,a
obstruction,1,0,2,0,1,2,6,a
jesus,11,0,17,0,1,23,52,a
following,1,0,0,0,1,1,3,a
welp,2,0,3,0,0,7,12,a
jr,12,0,1,1,8,2,24,a
watching sean spicer,8,14,0,0,1,1,24,a
spicer's job,1,3,0,0,0,0,4,a
eff,1,0,0,0,1,1,3,a
asshats,1,0,0,0,1,1,3,a
sean spicer barca,3,0,0,0,0,7,10,a
maga,0,0,0,7,3,2,12,a
defended hitler,1,3,0,0,0,12,16,a
swing,2,0,1,0,1,3,7,a
leftists,7,0,4,0,5,8,24,a
opposition,2,0,0,0,2,2,6,a
employment,2,0,0,0,2,1,5,a
jewish holiday,1,2,0,0,0,1,4,a
hitler comment,19,25,0,1,0,14,59,a
yesterday pepsi,1,3,0,0,0,0,4,a
billion,11,0,0,1,8,0,20,a
probe,3,0,0,0,2,0,5,a
sean spicer apologizes,27,46,0,0,0,27,100,a
make america great again,3,2,0,1,0,0,6,a
progressives,2,0,1,0,2,0,5,a
ww3,0,0,0,19,8,0,27,a
defending hitler on passover,2,1,0,0,0,2,5,a
amen,1,0,0,1,2,5,9,a
drumpf,6,0,0,0,6,0,12,a
worldwide,1,0,0,1,1,1,4,a
pants on fire,4,1,0,0,3,1,9,a
top 5,0,1,0,0,1,15,17,a
university,2,0,0,0,1,3,6,a
legal fisa,1,2,0,1,0,0,4,a
wh press secretary,5,8,0,0,0,1,14,a
goy,0,0,0,3,1,1,5,a
calls concentration camps,1,0,0,0,1,1,3,a
fbi fisa warrant,1,1,0,1,0,7,10,a
protecting,0,0,2,1,0,1,4,a
sister influenced presidentγçös decision,4,0,0,0,0,2,6,a
tfw,0,0,1,1,0,1,3,a
sale,1,0,0,0,1,2,4,a
pop,1,0,0,0,1,1,3,a
holocaust centre,6,4,0,0,4,3,17,a
holocaust gaffe,3,5,0,0,0,0,8,a
obama admin,1,3,0,0,0,1,5,a
impeach trump,1,2,0,0,0,1,4,a
trump transition,1,4,0,0,0,2,7,a
jeff sessions lied,0,0,0,4,0,0,4,a
bullshit stunt,1,1,0,0,0,2,4,a
american government,1,2,0,0,0,0,3,a
flash,2,0,1,0,1,1,5,a
hitler remarks at press briefing,3,0,0,0,0,0,3,a
praises hitler,1,3,0,0,0,0,4,a
seder,10,0,0,0,9,1,20,a
veterans,1,0,0,0,1,1,3,a
feathered,1,0,0,0,0,6,7,a
sean spicer proves,2,2,0,0,0,0,4,a
say eric,1,2,0,0,0,0,3,a
tv,2,0,0,42,11,2,57,a
holo,1,0,0,0,1,1,3,a
objectivity,1,0,1,0,1,4,7,a
replace spicer,2,3,0,0,0,0,5,a
receipts,0,0,0,2,1,0,3,a
russian spy,3,9,0,1,0,2,15,a
scholar lawprof,1,0,0,0,0,6,7,a
heγçös,2,7,0,0,0,0,9,a
generals,6,0,0,0,4,2,12,a
stupid is,5,0,0,0,6,2,13,a
carter page met,1,2,0,0,0,1,4,a
obviously sean spicer,2,2,0,0,0,0,4,a
sean spicer falsely stated,1,0,0,0,0,2,3,a
white house press briefing,8,5,0,0,0,3,16,a
holocaust centers sean spicer,3,0,0,0,0,3,6,a
spent,4,0,1,0,4,0,9,a
disabled germans,1,2,0,0,0,0,3,a
fire trump,1,3,0,0,0,1,5,a
social studies,1,0,0,0,1,1,3,a
sean spicer went on cnn,3,0,0,0,0,0,3,a
jim,2,0,0,0,1,3,6,a
sa,0,0,0,4,1,0,5,a
jews gassed,1,2,0,0,0,0,3,a
really sean spicer,1,1,0,0,0,3,5,a
meet in moscow on weekend,3,0,0,0,0,0,3,a
us government,1,2,0,0,0,0,3,a
safe zones,1,0,0,0,1,1,3,a
save sean spicer,2,2,0,0,0,2,6,a
bff,0,0,0,2,1,0,3,a
anne frank center calling,2,1,0,0,0,0,3,a
says ivanka,1,2,0,0,0,0,3,a
bannon in the white house,3,0,0,0,0,0,3,a
breaking,5,0,10,43,19,22,99,a
trumprussia,4,1,1,0,2,1,9,a
wag the dog,3,0,0,0,3,3,9,a
fo,0,0,0,2,1,0,3,a
stooges,2,0,0,0,2,0,4,a
court jester,3,0,0,0,3,0,6,a
gas jews,3,6,0,0,0,0,9,a
exclusive,2,0,3,0,1,0,6,a
matrix,1,0,0,0,1,1,3,a
barrel bomb,3,0,0,0,3,0,6,a
lefty,2,0,0,0,2,0,4,a
im,5,0,6,0,4,8,23,a
secretary of state tillerson,2,0,0,0,0,1,3,a
sean spicer video,2,2,0,0,0,0,4,a
trump news,1,0,0,0,1,1,3,a
knowγçö nazis used gas chambers,4,0,0,0,0,0,4,a
hitler gaffe causes uproar,2,0,0,0,0,2,4,a
fantastic,1,0,2,0,0,0,3,a
goonies,1,0,0,1,1,0,3,a
tfw alex jones,2,2,0,0,0,0,4,a
us eric trump,1,0,0,0,0,5,6,a
commander in chief,6,0,0,0,6,0,12,a
bears,1,0,0,0,1,1,3,a
middle class,1,0,0,0,1,1,3,a
reddit,1,0,0,0,1,1,3,a
pos,1,0,0,9,4,5,19,a
deplorables,1,0,0,0,1,1,3,a
bet sean spicer,2,2,0,0,0,0,4,a
argues assad gassing worse,1,0,0,0,0,2,3,a
hill,7,0,0,0,5,1,13,a
neil,1,0,0,0,0,4,5,a
lieu,1,0,0,0,1,1,3,a
crooks,3,0,0,0,2,0,5,a
passover seder,1,1,0,1,1,0,4,a
weγçöre,4,7,2,0,0,0,13,a
thegoodgodabove,1,0,3,0,0,0,4,a
sean spicer's clarification,1,1,0,0,0,3,5,a
sean spicer slammed,2,2,0,0,0,0,4,a
bbg,0,0,0,1,0,2,3,a
funding,1,0,0,1,1,1,4,a
trump's syria strike,2,2,0,0,0,2,6,a
liberal media,2,1,0,0,1,0,4,a
shutting,1,0,0,0,1,1,3,a
secretary of state rex tillerson,5,0,0,0,0,0,5,a
gizmodo,1,0,2,0,0,1,4,a
doesnγçöt,1,3,0,0,0,1,5,a
marketwatch,0,0,2,1,0,0,3,a
question of the day,3,0,0,0,1,0,4,a
comparing assad,1,2,0,0,0,1,4,a
uber,3,0,5,0,2,2,12,a
army,1,0,0,0,1,1,3,a
solves,4,0,0,0,3,1,8,a
youre,1,0,0,1,1,0,3,a
sees sean spicer,3,3,0,0,0,0,6,a
sean spicer justifies syria strike,4,0,0,0,0,0,4,a
communicator of the year,2,0,0,0,1,0,3,a
white house easter bunny,5,3,0,0,0,0,8,a
calls nepotism,2,0,0,0,2,0,4,a
jews on holocaust remembrance day,4,0,0,0,0,0,4,a
trump aide,5,15,0,0,1,3,24,a
united flights,1,2,0,0,0,0,3,a
western,6,0,2,0,5,0,13,a
donγçöt,1,2,4,0,0,0,7,a
give mediocre white men microphones,3,0,0,0,0,0,3,a
mate,1,0,0,0,1,1,3,a
russia prior,1,2,0,0,0,0,3,a
ffs,0,0,1,15,3,14,33,a
syria strikes,2,6,0,0,0,2,10,a
hitler comments,6,23,0,0,0,12,41,a
iγçöve,1,1,2,0,0,0,4,a
memo,1,0,0,0,1,2,4,a
sean spicerγçös firing,4,6,0,0,0,0,10,a
north korea threatens,1,1,0,0,0,1,3,a
update,1,0,1,3,2,2,9,a
ba,0,0,0,1,0,2,3,a
man sean spicer,3,2,0,0,1,1,7,a
ap,0,0,0,3,1,1,5,a
boom,6,0,2,7,4,19,38,a
sean spicer meant,4,4,0,0,0,1,9,a
sean spicer's mental health grows,3,0,0,0,0,0,3,a
sean spicer grovels,2,2,0,0,0,0,4,a
sam,2,0,0,0,2,0,4,a
clickhole,2,0,1,0,1,0,4,a
pt,1,0,0,0,1,6,8,a
chase,1,0,0,0,1,1,3,a
increase,2,0,0,0,2,0,4,a
wh easter bunny,2,3,0,0,0,0,5,a
constitutional,2,0,0,0,2,0,4,a
stock market,2,1,0,0,2,0,5,a
ellemagazine,1,0,2,0,0,0,3,a
peanuts,1,0,0,0,1,1,3,a
tower,3,0,0,0,2,0,5,a
ca,0,0,0,4,1,1,6,a
patience,2,0,0,0,2,0,4,a
satan,2,0,2,0,1,0,5,a
sean spicer show,2,2,0,0,0,0,4,a
spreading holocaust denial,2,2,0,0,0,3,7,a
polish death camps,0,0,0,1,0,2,3,a
wmd,0,0,0,3,1,0,4,a
millions of americans,1,1,0,0,0,1,3,a
sean spicer causes uproar,5,1,0,0,0,3,9,a
globalists,2,0,0,0,2,1,5,a
ah,4,0,12,2,1,7,26,a
6m,0,0,0,2,1,0,3,a
kabuki,2,0,1,0,1,0,4,a
issa,1,0,2,0,0,0,3,a
tarred,1,0,0,0,0,6,7,a
nastiest,0,0,0,4,1,0,5,a
eric trump may,2,3,0,0,0,1,6,a
ru,0,0,0,4,1,0,5,a
bull shit,1,1,0,1,1,0,4,a
chill,1,0,0,0,1,1,3,a
americas,3,0,0,0,2,0,5,a
robbing,0,0,0,1,0,2,3,a
candidate,cap,substring-cap,s-o-sCap,all-cap,non-cap,non-discriminative,cumulative,status
ask sean spicer,2,2,0,0,0,2,6,a
meals on wheels,2,2,0,0,1,0,5,a
agreed,2,0,2,1,2,3,10,a
republican,12,0,4,0,7,6,29,a
nazi death camps,3,5,0,0,0,0,8,a
senator,2,0,0,0,2,1,5,a
senators,2,0,0,0,2,1,5,a
ww1,0,0,0,4,1,0,5,a
devil,3,0,0,0,2,0,5,a
syria strike proves,11,9,0,0,0,6,26,a
clearance,1,0,0,0,1,2,4,a
apparently hitler,1,2,0,0,0,0,3,a
adminstration,2,0,0,0,2,0,4,a
bingo,3,0,0,0,3,0,6,a
thereγçös,1,2,1,0,0,0,4,a
hitler comparison,3,4,0,0,0,3,10,a
attack on syria,2,2,0,0,0,0,4,a
syria strike,18,48,0,0,0,6,72,a
united ceo oscar munoz,3,0,0,1,0,1,5,a
trump told,1,3,0,0,0,0,4,a
god,56,0,13,2,60,49,180,a
easter egg,0,1,0,0,0,5,6,a
whites,2,0,0,0,1,2,5,a
russia ties,11,29,0,0,1,7,48,a
sean spicer draws backlash,49,0,0,0,0,24,73,a
literally hitler,1,7,0,1,0,8,17,a
sob,1,0,0,2,2,1,6,a
press secretary sean spicer,48,11,0,0,0,9,68,a
ice,0,0,0,4,2,0,6,a
measured,2,0,0,0,2,0,4,a
infowars,12,0,3,0,6,4,25,a
eric trump admits,4,4,0,0,0,2,10,a
bye bye,2,1,0,0,1,3,7,a
geez,1,0,5,0,0,1,7,a
reaccomodated,2,0,0,0,2,0,4,a
pepsi ad,1,2,0,0,0,1,4,a
cillizza,8,0,18,0,0,0,26,a
soldier,3,0,0,0,2,0,5,a
missile strike in syria,5,2,0,0,0,1,8,a
don the con,3,3,0,1,0,0,7,a
big win,1,0,0,0,1,3,5,a
daughter ivanka,2,3,0,0,0,4,9,a
pops,2,0,0,0,2,0,4,a
orchestrated,2,0,0,0,2,0,4,a
your fired,1,0,0,0,1,1,3,a
sean spicer's false claim,2,0,0,0,0,1,3,a
woah,1,0,1,0,0,3,5,a
jesus,11,0,17,0,1,23,52,a
following,1,0,0,0,1,1,3,a
civil rights,1,0,0,0,1,1,3,a
welp,2,0,3,0,0,7,12,a
jr,12,0,1,1,8,2,24,a
watching sean spicer,8,14,0,0,1,1,24,a
spicer's job,1,3,0,0,0,0,4,a
eff,1,0,0,0,1,1,3,a
asshats,1,0,0,0,1,1,3,a
sean spicer barca,3,0,0,0,0,7,10,a
maga,0,0,0,7,3,2,12,a
defended hitler,1,3,0,0,0,12,16,a
swing,2,0,1,0,1,3,7,a
leftists,7,0,5,0,5,10,27,a
opposition,2,0,0,0,2,2,6,a
employment,2,0,0,0,2,1,5,a
jewish holiday,1,3,0,0,0,1,5,a
hitler comment,19,29,0,1,0,14,63,a
yesterday pepsi,1,3,0,0,0,0,4,a
billion,11,0,0,1,8,0,20,a
sean spicer apologizes,27,46,0,0,0,27,100,a
make america great again,3,2,0,1,0,0,6,a
ww3,0,0,0,19,8,0,27,a
defending hitler on passover,2,1,0,0,0,2,5,a
amen,1,0,0,1,2,5,9,a
drumpf,6,0,0,0,6,0,12,a
worldwide,1,0,0,1,1,1,4,a
pants on fire,4,1,0,0,3,1,9,a
politifact,1,0,2,0,0,0,3,a
top 5,0,1,0,0,1,15,17,a
university,2,0,0,0,1,3,6,a
legal fisa,1,2,0,1,0,0,4,a
wh press secretary,5,8,0,0,0,1,14,a
goy,0,0,0,3,1,1,5,a
fbi fisa warrant,1,1,0,1,0,7,10,a
protecting,0,0,2,1,0,1,4,a
sister influenced presidentγçös decision,4,0,0,0,0,2,6,a
tfw,0,0,1,1,0,1,3,a
sale,1,0,0,0,1,2,4,a
pop,1,0,0,0,1,1,3,a
holocaust centre,6,4,0,0,4,3,17,a
holocaust gaffe,3,5,0,0,0,0,8,a
obama admin,1,3,0,0,0,1,5,a
impeach trump,1,2,0,0,0,1,4,a
jeff sessions lied,0,0,0,4,0,0,4,a
bullshit stunt,1,1,0,0,0,2,4,a
american government,1,2,0,0,0,0,3,a
north korean problem,2,1,0,0,0,2,5,a
flash,2,0,1,0,2,1,6,a
hitler remarks at press briefing,3,0,0,0,0,0,3,a
praises hitler,1,3,0,0,0,0,4,a
seder,10,0,0,0,9,1,20,a
veterans,1,0,0,0,1,1,3,a
feathered,1,0,0,0,0,6,7,a
sean spicer proves,2,2,0,0,0,0,4,a
say eric,1,2,0,0,0,0,3,a
tv,2,0,0,42,11,2,57,a
holo,1,0,0,0,1,1,3,a
objectivity,1,0,1,0,1,4,7,a
replace spicer,2,3,0,0,0,0,5,a
receipts,0,0,0,2,1,0,3,a
russian spy,3,9,0,1,0,2,15,a
scholar lawprof,1,0,0,0,0,6,7,a
generals,6,0,0,0,4,2,12,a
stupid is,5,0,0,0,6,2,13,a
carter page met,1,2,0,0,0,1,4,a
obviously sean spicer,2,2,0,0,0,0,4,a
sean spicer falsely stated,1,0,0,0,0,2,3,a
white house press briefing,8,5,0,0,0,4,17,a
holocaust centers sean spicer,3,0,0,0,0,3,6,a
spent,4,0,1,0,4,0,9,a
disabled germans,1,2,0,0,0,0,3,a
fire trump,1,3,0,0,0,1,5,a
social studies,1,0,0,0,1,1,3,a
sean spicer went on cnn,3,0,0,0,0,0,3,a
jim,2,0,0,0,1,3,6,a
whoops,1,0,2,0,0,0,3,a
sa,0,0,0,4,1,0,5,a
jews gassed,1,2,0,0,0,0,3,a
really sean spicer,1,1,0,0,0,3,5,a
meet in moscow on weekend,3,0,0,0,0,0,3,a
us government,1,2,0,0,0,0,3,a
safe zones,1,0,0,0,1,1,3,a
save sean spicer,2,2,0,0,0,2,6,a
bff,0,0,0,2,1,0,3,a
anne frank center calling,2,1,0,0,0,0,3,a
says ivanka,1,2,0,0,0,0,3,a
bannon in the white house,3,0,0,0,0,0,3,a
breaking,5,0,10,43,19,22,99,a
trumprussia,4,1,1,0,2,1,9,a
wag the dog,3,0,0,0,3,3,9,a
fo,0,0,0,2,1,0,3,a
stooges,2,0,0,0,2,0,4,a
court jester,3,0,0,0,3,0,6,a
gas jews,3,6,0,0,0,0,9,a
exclusive,2,0,3,0,1,0,6,a
matrix,1,0,0,0,1,1,3,a
barrel bomb,3,0,0,0,3,1,7,a
lefty,2,0,0,0,2,0,4,a
im,5,0,6,0,4,8,23,a
secretary of state tillerson,2,0,0,0,0,1,3,a
sean spicer video,2,2,0,0,0,0,4,a
sheesh,1,0,1,0,0,2,4,a
trump news,1,0,0,0,1,1,3,a
knowγçö nazis used gas chambers,4,0,0,0,0,0,4,a
hitler gaffe causes uproar,2,0,0,0,0,2,4,a
fantastic,1,0,2,0,0,0,3,a
goonies,1,0,0,1,1,0,3,a
tfw alex jones,2,2,0,0,0,0,4,a
us eric trump,1,0,0,0,0,5,6,a
commander in chief,6,0,0,0,6,0,12,a
bears,1,0,0,0,1,1,3,a
middle class,1,0,0,0,1,1,3,a
reddit,1,0,0,0,1,1,3,a
pos,1,0,0,9,4,5,19,a
deplorables,1,0,0,0,1,1,3,a
bet sean spicer,2,2,0,0,0,0,4,a
argues assad gassing worse,1,0,0,0,0,2,3,a
teamsters,1,0,2,0,0,0,3,a
hill,7,0,0,0,5,1,13,a
neil,1,0,0,0,0,4,5,a
lieu,1,0,0,0,1,1,3,a
crooks,3,0,0,0,2,0,5,a
passover seder,1,2,0,1,1,0,5,a
weγçöre,4,7,2,0,0,0,13,a
thegoodgodabove,1,0,3,0,0,0,4,a
sean spicer's clarification,1,1,0,0,0,3,5,a
sean spicer slammed,2,2,0,0,0,0,4,a
bbg,0,0,0,1,0,2,3,a
trump's syria strike,2,2,0,0,0,2,6,a
liberal media,2,1,0,0,1,0,4,a
shutting,1,0,0,0,1,1,3,a
weeks,2,0,0,0,2,0,4,a
secretary of state rex tillerson,5,0,0,0,0,0,5,a
gizmodo,1,0,2,0,0,1,4,a
doesnγçöt,1,3,0,0,0,1,5,a
marketwatch,0,0,2,1,0,0,3,a
question of the day,3,0,0,0,1,0,4,a
comparing assad,1,3,0,0,0,1,5,a
travel ban,2,1,0,0,2,0,5,a
uber,3,0,5,0,2,2,12,a
army,1,0,0,0,1,1,3,a
solves,4,0,0,0,3,1,8,a
youre,1,0,0,1,1,0,3,a
sees sean spicer,3,3,0,0,0,0,6,a
sean spicer justifies syria strike,4,0,0,0,0,0,4,a
communicator of the year,2,0,0,0,1,0,3,a
white house easter bunny,5,3,0,0,0,0,8,a
calls nepotism,2,0,0,0,2,0,4,a
jews on holocaust remembrance day,4,0,0,0,0,0,4,a
united flights,1,2,0,0,0,0,3,a
western,6,0,2,0,5,0,13,a
donγçöt,1,2,4,0,0,0,7,a
give mediocre white men microphones,3,0,0,0,0,0,3,a
russia prior,1,2,0,0,0,0,3,a
ffs,0,0,1,15,3,14,33,a
syria strikes,2,6,0,0,0,2,10,a
hitler comments,6,24,0,0,0,12,42,a
iγçöve,1,1,2,0,0,0,4,a
memo,1,0,0,0,1,2,4,a
sean spicerγçös firing,4,6,0,0,0,0,10,a
north korea threatens,1,1,0,0,0,1,3,a
update,1,0,1,3,2,2,9,a
ba,0,0,0,1,0,2,3,a
man sean spicer,3,2,0,0,1,1,7,a
ap,0,0,0,3,1,1,5,a
boom,6,0,2,7,4,19,38,a
sean spicer meant,4,4,0,0,0,1,9,a
sean spicer's mental health grows,3,0,0,0,0,0,3,a
sean spicer grovels,2,2,0,0,0,0,4,a
sam,2,0,0,0,2,0,4,a
clickhole,2,0,1,0,1,0,4,a
pt,1,0,0,0,1,6,8,a
chase,1,0,0,0,1,1,3,a
increase,2,0,0,0,2,0,4,a
sean spicer credits hitler,4,0,0,0,0,4,8,a
wh easter bunny,2,3,0,0,0,0,5,a
constitutional,2,0,0,0,2,0,4,a
stock market,2,1,0,0,2,0,5,a
ellemagazine,1,0,2,0,0,0,3,a
gifs,2,0,0,0,1,2,5,a
peanuts,1,0,0,0,1,1,3,a
tower,3,0,0,0,2,0,5,a
ca,0,0,0,4,1,1,6,a
patience,2,0,0,0,2,0,4,a
satan,2,0,2,0,1,0,5,a
sean spicer show,2,2,0,0,0,0,4,a
spreading holocaust denial,2,2,0,0,0,3,7,a
polish death camps,0,0,0,1,0,2,3,a
wmd,0,0,0,3,1,0,4,a
millions of americans,1,1,0,0,0,1,3,a
induced,1,0,0,0,1,1,3,a
nazi gas,1,2,0,0,0,0,3,a
sean spicer causes uproar,5,1,0,0,0,3,9,a
ah,4,0,12,2,1,7,26,a
6m,0,0,0,2,1,0,3,a
kabuki,2,0,1,0,1,0,4,a
issa,1,0,2,0,0,0,3,a
tarred,1,0,0,0,0,6,7,a
nastiest,0,0,0,4,1,0,5,a
eric trump may,2,3,0,0,0,1,6,a
ru,0,0,0,4,1,0,5,a
bull shit,1,1,0,1,1,0,4,a
holocaust center,64,40,0,1,25,20,150,a
chill,1,0,0,0,1,1,3,a
americas,3,0,0,0,2,0,5,a
robbing,0,0,0,1,0,2,3,a
candidate,cap,substring-cap,s-o-sCap,all-cap,non-cap,non-discriminative,cumulative,status
ask sean spicer,2,3,0,0,0,2,7,a
meals on wheels,2,2,0,0,1,0,5,a
agreed,2,0,2,1,2,3,10,a
republican,12,0,4,0,7,6,29,a
nazi death camps,3,5,0,0,0,0,8,a
senator,2,0,0,0,2,1,5,a
senators,2,0,0,0,2,1,5,a
ww1,0,0,0,4,1,0,5,a
devil,3,0,0,0,2,0,5,a
syria strike proves,11,9,0,0,0,6,26,a
clearance,1,0,0,0,1,2,4,a
apparently hitler,1,2,0,0,0,0,3,a
adminstration,2,0,0,0,2,0,4,a
bingo,3,0,0,0,3,0,6,a
thereγçös,1,2,1,0,0,0,4,a
hitler comparison,4,6,0,0,0,3,13,a
attack on syria,2,2,0,0,0,0,4,a
syria strike,18,48,0,0,0,6,72,a
united ceo oscar munoz,3,0,0,1,0,1,5,a
trump told,1,3,0,0,0,0,4,a
god,56,0,13,2,60,49,180,a
easter egg,0,1,0,0,0,5,6,a
whites,2,0,0,0,1,2,5,a
russia ties,11,29,0,0,1,7,48,a
sean spicer draws backlash,49,0,0,0,0,24,73,a
literally hitler,1,7,0,1,0,8,17,a
sob,1,0,0,2,2,1,6,a
press secretary sean spicer,48,11,0,0,0,9,68,a
ice,0,0,0,4,2,0,6,a
measured,2,0,0,0,2,0,4,a
eric trump admits,4,4,0,0,0,2,10,a
bye bye,2,2,0,0,1,3,8,a
geez,1,0,5,0,0,1,7,a
reaccomodated,2,0,0,0,2,0,4,a
pepsi ad,1,2,0,0,0,1,4,a
cillizza,8,0,18,0,0,0,26,a
soldier,3,0,0,0,2,0,5,a
missile strike in syria,5,2,0,0,0,1,8,a
don the con,3,3,0,1,0,0,7,a
big win,1,0,0,0,1,3,5,a
pushed,8,0,0,0,5,0,13,a
daughter ivanka,2,3,0,0,0,4,9,a
pops,2,0,0,0,2,0,4,a
your fired,1,0,0,0,1,1,3,a
sean spicer's false claim,2,0,0,0,0,1,3,a
woah,1,0,1,0,0,3,5,a
jesus,11,0,17,0,1,23,52,a
following,1,0,0,0,1,1,3,a
civil rights,1,0,0,0,1,1,3,a
welp,2,0,3,0,0,7,12,a
jr,12,0,1,1,8,2,24,a
watching sean spicer,8,14,0,0,1,1,24,a
spicer's job,1,3,0,0,0,0,4,a
eff,1,0,0,0,1,1,3,a
asshats,1,0,0,0,1,1,3,a
sean spicer barca,3,0,0,0,0,7,10,a
maga,0,0,0,7,3,2,12,a
defended hitler,1,3,0,0,0,12,16,a
god bless,2,3,0,0,0,1,6,a
swing,2,0,1,0,1,3,7,a
leftists,7,0,5,0,5,10,27,a
opposition,2,0,0,0,2,2,6,a
employment,2,0,0,0,2,1,5,a
jewish holiday,1,3,0,0,0,1,5,a
hitler comment,19,32,0,1,0,14,66,a
yesterday pepsi,1,3,0,0,0,0,4,a
billion,11,0,0,1,8,0,20,a
sean spicer apologizes,27,46,0,0,0,27,100,a
make america great again,3,2,0,1,0,0,6,a
ww3,0,0,0,19,8,0,27,a
defending hitler on passover,2,1,0,0,0,2,5,a
amen,1,0,0,1,2,5,9,a
drumpf,6,0,0,0,6,0,12,a
worldwide,1,0,0,1,1,1,4,a
corp,1,0,0,0,1,1,3,a
pants on fire,4,1,0,0,3,1,9,a
politifact,1,0,2,0,0,0,3,a
top 5,0,1,0,0,1,15,17,a
university,2,0,0,0,1,3,6,a
legal fisa,1,2,0,1,0,0,4,a
wh press secretary,5,9,0,0,0,1,15,a
goy,0,0,0,3,1,1,5,a
fbi fisa warrant,1,1,0,1,0,7,10,a
protecting,0,0,2,1,0,1,4,a
sister influenced presidentγçös decision,4,0,0,0,0,2,6,a
tfw,0,0,1,1,0,1,3,a
sale,1,0,0,0,1,2,4,a
pop,1,0,0,0,1,1,3,a
holocaust centre,6,4,0,0,4,3,17,a
holocaust gaffe,3,5,0,0,0,0,8,a
obama admin,1,3,0,0,0,1,5,a
impeach trump,1,2,0,0,0,1,4,a
jeff sessions lied,0,0,0,4,0,0,4,a
bullshit stunt,1,1,0,0,0,2,4,a
american government,1,2,0,0,0,0,3,a
potato,2,0,0,0,2,0,4,a
flash,2,0,1,0,2,1,6,a
hitler remarks at press briefing,3,0,0,0,0,0,3,a
praises hitler,1,3,0,0,0,0,4,a
seder,10,0,0,0,9,1,20,a
feathered,1,0,0,0,0,6,7,a
sean spicer proves,2,2,0,0,0,0,4,a
say eric,1,2,0,0,0,0,3,a
tv,2,0,0,42,11,2,57,a
holo,1,0,0,0,1,1,3,a
objectivity,1,0,1,0,1,4,7,a
replace spicer,2,3,0,0,0,0,5,a
receipts,0,0,0,2,1,0,3,a
russian spy,3,9,0,1,0,2,15,a
scholar lawprof,1,0,0,0,0,6,7,a
denying,1,0,0,0,1,1,3,a
generals,6,0,0,0,4,2,12,a
stupid is,5,0,0,0,6,2,13,a
carter page met,1,2,0,0,0,1,4,a
obviously sean spicer,2,2,0,0,0,0,4,a
sean spicer falsely stated,1,0,0,0,0,2,3,a
white house press briefing,8,5,0,0,0,4,17,a
holocaust centers sean spicer,3,0,0,0,0,3,6,a
spent,4,0,1,0,4,0,9,a
disabled germans,1,2,0,0,0,0,3,a
fire trump,1,3,0,0,0,1,5,a
social studies,1,0,0,0,1,1,3,a
sean spicer went on cnn,3,0,0,0,0,0,3,a
jim,2,0,0,0,1,3,6,a
whoops,1,0,2,0,0,0,3,a
sa,0,0,0,4,1,0,5,a
jews gassed,1,2,0,0,0,0,3,a
really sean spicer,1,1,0,0,0,3,5,a
meet in moscow on weekend,3,0,0,0,0,0,3,a
us government,1,2,0,0,0,0,3,a
safe zones,1,0,0,0,1,1,3,a
save sean spicer,2,2,0,0,0,2,6,a
bff,0,0,0,2,1,0,3,a
anne frank center calling,2,1,0,0,0,0,3,a
says ivanka,1,2,0,0,0,0,3,a
bannon in the white house,3,0,0,0,0,0,3,a
breaking,5,0,10,43,19,22,99,a
trumprussia,4,1,1,0,2,1,9,a
wag the dog,3,0,0,0,3,3,9,a
fo,0,0,0,2,1,0,3,a
stooges,2,0,0,0,2,0,4,a
court jester,3,0,0,0,3,0,6,a
gas jews,3,6,0,0,0,0,9,a
exclusive,2,0,3,0,1,0,6,a
matrix,1,0,0,0,1,1,3,a
barrel bomb,3,0,0,0,3,1,7,a
lefty,2,0,0,0,2,0,4,a
im,5,0,6,0,4,8,23,a
secretary of state tillerson,2,0,0,0,0,1,3,a
sean spicer video,2,2,0,0,0,0,4,a
trump news,1,0,0,0,1,1,3,a
knowγçö nazis used gas chambers,4,0,0,0,0,0,4,a
hitler gaffe causes uproar,2,0,0,0,0,2,4,a
fantastic,1,0,2,0,0,0,3,a
goonies,1,0,0,1,1,0,3,a
tfw alex jones,2,2,0,0,0,0,4,a
us eric trump,1,0,0,0,0,5,6,a
commander in chief,6,0,0,0,6,0,12,a
bears,1,0,0,0,1,1,3,a
middle class,1,0,0,0,1,1,3,a
reddit,1,0,0,0,1,1,3,a
pos,1,0,0,9,4,5,19,a
deplorables,1,0,0,0,1,1,3,a
bet sean spicer,2,2,0,0,0,0,4,a
argues assad gassing worse,1,0,0,0,0,2,3,a
teamsters,1,0,2,0,0,0,3,a
hill,7,0,0,0,5,1,13,a
neil,1,0,0,0,0,4,5,a
lieu,1,0,0,0,1,1,3,a
crooks,3,0,0,0,2,0,5,a
passover seder,1,2,0,1,1,0,5,a
weγçöre,4,7,2,0,0,0,13,a
thegoodgodabove,1,0,3,0,0,0,4,a
sean spicer's clarification,1,1,0,0,0,3,5,a
sean spicer slammed,2,2,0,0,0,0,4,a
bbg,0,0,0,1,0,2,3,a
trump's syria strike,2,2,0,0,0,2,6,a
liberal media,2,1,0,0,1,0,4,a
shutting,1,0,0,0,1,1,3,a
secretary of state rex tillerson,5,0,0,0,0,0,5,a
gizmodo,1,0,2,0,0,1,4,a
doesnγçöt,1,3,0,0,0,1,5,a
marketwatch,0,0,2,1,0,0,3,a
question of the day,3,0,0,0,1,0,4,a
comparing assad,1,3,0,0,0,1,5,a
uber,3,0,5,0,2,2,12,a
army,1,0,0,0,1,1,3,a
solves,4,0,0,0,3,1,8,a
youre,1,0,0,1,1,0,3,a
sees sean spicer,3,3,0,0,0,0,6,a
sean spicer justifies syria strike,4,0,0,0,0,0,4,a
communicator of the year,2,0,0,0,1,0,3,a
white house easter bunny,5,3,0,0,0,0,8,a
calls nepotism,2,0,0,0,2,0,4,a
jews on holocaust remembrance day,4,0,0,0,0,0,4,a
united flights,1,2,0,0,0,0,3,a
western,6,0,2,0,5,0,13,a
mall,2,0,0,0,2,0,4,a
give mediocre white men microphones,3,0,0,0,0,0,3,a
russia prior,1,2,0,0,0,0,3,a
ffs,0,0,1,15,3,14,33,a
syria strikes,2,6,0,0,0,2,10,a
hitler comments,6,24,0,0,0,13,43,a
iγçöve,1,1,2,0,0,0,4,a
memo,1,0,0,0,1,2,4,a
mike,4,0,1,0,2,5,12,a
sean spicerγçös firing,4,6,0,0,0,0,10,a
north korea threatens,1,1,0,0,0,1,3,a
update,1,0,1,3,2,2,9,a
ba,0,0,0,1,0,2,3,a
man sean spicer,3,2,0,0,1,1,7,a
ap,0,0,0,3,1,1,5,a
boom,6,0,2,7,4,19,38,a
sean spicer meant,4,4,0,0,0,1,9,a
sean spicer's mental health grows,3,0,0,0,0,0,3,a
sean spicer grovels,2,2,0,0,0,0,4,a
sam,2,0,0,0,2,0,4,a
clickhole,2,0,1,0,1,0,4,a
pt,1,0,0,0,1,6,8,a
chase,1,0,0,0,1,1,3,a
increase,2,0,0,0,2,0,4,a
sean spicer credits hitler,4,0,0,0,0,4,8,a
wh easter bunny,2,3,0,0,0,0,5,a
constitutional,2,0,0,0,2,0,4,a
stock market,2,1,0,0,2,0,5,a
ellemagazine,1,0,2,0,0,0,3,a
gifs,2,0,0,0,1,2,5,a
peanuts,1,0,0,0,1,1,3,a
tower,3,0,0,0,2,0,5,a
ca,0,0,0,4,1,1,6,a
patience,2,0,0,0,2,0,4,a
satan,2,0,2,0,1,0,5,a
sean spicer show,2,3,0,0,0,0,5,a
spreading holocaust denial,2,2,0,0,0,3,7,a
polish death camps,0,0,0,1,0,2,3,a
wmd,0,0,0,3,1,0,4,a
millions of americans,1,1,0,0,0,1,3,a
nazi gas,1,2,0,0,0,0,3,a
sean spicer causes uproar,5,1,0,0,0,3,9,a
tiny,1,0,0,0,0,4,5,a
ah,4,0,12,2,1,7,26,a
6m,0,0,0,2,1,0,3,a
kabuki,2,0,1,0,1,0,4,a
issa,1,0,2,0,0,0,3,a
tarred,1,0,0,0,0,6,7,a
nastiest,0,0,0,4,1,0,5,a
eric trump may,2,3,0,0,0,1,6,a
ru,0,0,0,4,1,0,5,a
bull shit,1,1,0,1,1,0,4,a
holocaust center,64,40,0,1,25,20,150,a
chill,1,0,0,0,1,1,3,a
americas,3,0,0,0,2,0,5,a
robbing,0,0,0,1,0,2,3,a
candidate,cap,substring-cap,s-o-sCap,all-cap,non-cap,non-discriminative,cumulative,status
meals on wheels,2,2,0,0,1,0,5,a
agreed,2,0,2,1,2,3,10,a
republican,12,0,4,0,7,6,29,a
nazi death camps,3,5,0,0,0,0,8,a
senator,2,0,0,0,2,1,5,a
senators,2,0,0,0,2,1,5,a
ww1,0,0,0,4,1,0,5,a
sean spicer saying,1,2,0,0,0,0,3,a
devil,3,0,0,0,2,0,5,a
syria strike proves,11,9,0,0,0,6,26,a
clearance,1,0,0,0,1,2,4,a
apparently hitler,1,2,0,0,0,0,3,a
adminstration,2,0,0,0,2,0,4,a
bingo,3,0,0,0,3,0,6,a
thereγçös,1,2,1,0,0,0,4,a
hitler comparison,4,6,0,0,0,3,13,a
attack on syria,2,2,0,0,0,0,4,a
syria strike,18,48,0,0,0,6,72,a
united ceo oscar munoz,3,0,0,1,0,1,5,a
trump told,1,3,0,0,0,0,4,a
god,56,0,13,2,60,49,180,a
easter egg,0,1,0,0,0,5,6,a
whites,2,0,0,0,1,2,5,a
russia ties,11,29,0,0,1,7,48,a
sean spicer draws backlash,49,0,0,0,0,24,73,a
literally hitler,1,7,0,1,0,8,17,a
sob,1,0,0,2,2,1,6,a
press secretary sean spicer,48,11,0,0,0,9,68,a
ice,0,0,0,4,2,0,6,a
measured,2,0,0,0,2,0,4,a
infowars,12,0,3,0,6,4,25,a
eric trump admits,4,4,0,0,0,2,10,a
bye bye,2,2,0,0,1,3,8,a
geez,1,0,5,0,0,1,7,a
reaccomodated,2,0,0,0,2,0,4,a
pepsi ad,1,2,0,0,0,1,4,a
cillizza,8,0,18,0,0,0,26,a
soldier,3,0,0,0,2,0,5,a
missile strike in syria,5,2,0,0,0,1,8,a
don the con,3,3,0,1,0,0,7,a
big win,1,0,0,0,1,3,5,a
pushed,8,0,0,0,5,0,13,a
daughter ivanka,2,3,0,0,0,4,9,a
pops,2,0,0,0,2,0,4,a
press secretary sean,1,2,0,0,0,0,3,a
your fired,1,0,0,0,1,1,3,a
sean spicer's false claim,2,0,0,0,0,1,3,a
woah,1,0,1,0,0,3,5,a
obstruction,1,0,2,0,1,2,6,a
jesus,11,0,17,0,1,23,52,a
following,1,0,0,0,1,1,3,a
civil rights,1,0,0,0,1,1,3,a
welp,2,0,3,0,0,7,12,a
jr,12,0,1,1,8,2,24,a
watching sean spicer,8,14,0,0,1,1,24,a
eff,1,0,0,0,1,1,3,a
asshats,1,0,0,0,1,1,3,a
white people,1,0,0,0,1,1,3,a
sean spicer barca,3,0,0,0,0,7,10,a
eric trump proves,1,2,0,0,0,0,3,a
maga,0,0,0,7,3,2,12,a
defended hitler,1,3,0,0,0,12,16,a
god bless,2,3,0,0,0,1,6,a
swing,2,0,1,0,1,3,7,a
leftists,7,0,5,0,5,10,27,a
opposition,2,0,0,0,2,2,6,a
employment,2,0,0,0,2,1,5,a
jewish holiday,1,3,0,0,0,1,5,a
hitler comment,19,32,0,1,0,14,66,a
yesterday pepsi,1,3,0,0,0,0,4,a
billion,11,0,0,1,8,0,20,a
sean spicer apologizes,27,46,0,0,0,27,100,a
make america great again,3,2,0,1,0,0,6,a
progressives,2,0,1,0,2,0,5,a
ww3,0,0,0,19,8,0,27,a
defending hitler on passover,2,1,0,0,0,2,5,a
amen,1,0,0,1,2,5,9,a
drumpf,6,0,0,0,6,0,12,a
watched sean spicer,1,2,0,0,0,0,3,a
worldwide,1,0,0,1,1,1,4,a
corp,1,0,0,0,1,2,4,a
pants on fire,4,1,0,0,3,1,9,a
politifact,1,0,2,0,0,0,3,a
top 5,0,1,0,0,1,15,17,a
university,2,0,0,0,1,3,6,a
legal fisa,1,2,0,1,0,0,4,a
wh press secretary,5,9,0,0,0,1,15,a
goy,0,0,0,3,1,1,5,a
guess sean spicer,1,2,0,0,0,0,3,a
fbi fisa warrant,1,1,0,1,0,7,10,a
protecting,0,0,2,1,0,1,4,a
sister influenced presidentγçös decision,4,0,0,0,0,2,6,a
tfw,0,0,1,1,0,1,3,a
sale,1,0,0,0,1,2,4,a
pop,1,0,0,0,1,1,3,a
holocaust centre,6,4,0,0,4,3,17,a
holocaust gaffe,3,5,0,0,0,0,8,a
obama admin,1,3,0,0,0,1,5,a
impeach trump,1,2,0,0,0,1,4,a
jeff sessions lied,0,0,0,4,0,0,4,a
bullshit stunt,1,1,0,0,0,2,4,a
american government,1,2,0,0,0,0,3,a
potato,2,0,0,0,2,0,4,a
north korean problem,2,1,0,0,0,2,5,a
flash,2,0,1,0,2,1,6,a
hitler remarks at press briefing,3,0,0,0,0,0,3,a
praises hitler,1,3,0,0,0,0,4,a
seder,10,0,0,0,9,1,20,a
feathered,1,0,0,0,0,6,7,a
sean spicer proves,2,2,0,0,0,0,4,a
say eric,1,2,0,0,0,0,3,a
tv,2,0,0,42,11,2,57,a
holo,1,0,0,0,1,1,3,a
objectivity,1,0,1,0,1,4,7,a
replace spicer,2,3,0,0,0,0,5,a
getting a fisa,1,2,0,0,0,0,3,a
receipts,0,0,0,2,1,0,3,a
russian spy,3,9,0,1,0,2,15,a
regarding sean spicer,1,2,0,0,0,0,3,a
scholar lawprof,1,0,0,0,0,6,7,a
heγçös,2,7,0,0,0,0,9,a
generals,6,0,0,0,4,2,12,a
stupid is,5,0,0,0,6,2,13,a
carter page met,1,2,0,0,0,1,4,a
obviously sean spicer,2,2,0,0,0,0,4,a
tf,0,0,1,7,4,1,13,a
sean spicer falsely stated,1,0,0,0,0,2,3,a
white house press briefing,8,5,0,0,0,4,17,a
holocaust centers sean spicer,3,0,0,0,0,3,6,a
spent,4,0,1,0,4,0,9,a
disabled germans,1,2,0,0,0,0,3,a
fire trump,1,3,0,0,0,1,5,a
doctors,2,0,0,0,2,0,4,a
social studies,1,0,0,0,1,1,3,a
sean spicer went on cnn,3,0,0,0,0,0,3,a
jim,2,0,0,0,1,3,6,a
whoops,1,0,2,0,0,0,3,a
sa,0,0,0,4,1,0,5,a
jews gassed,1,2,0,0,0,0,3,a
really sean spicer,1,1,0,0,0,3,5,a
meet in moscow on weekend,3,0,0,0,0,0,3,a
us government,1,2,0,0,0,0,3,a
safe zones,1,0,0,0,1,1,3,a
save sean spicer,2,2,0,0,0,2,6,a
bff,0,0,0,2,1,0,3,a
anne frank center calling,2,1,0,0,0,0,3,a
says ivanka,1,2,0,0,0,0,3,a
bannon in the white house,3,0,0,0,0,0,3,a
breaking,5,0,10,43,19,22,99,a
trumprussia,4,1,1,0,2,1,9,a
wag the dog,3,0,0,0,3,3,9,a
fo,0,0,0,2,1,0,3,a
stooges,2,0,0,0,2,0,4,a
court jester,3,0,0,0,3,0,6,a
gas jews,3,6,0,0,0,0,9,a
exclusive,2,0,3,0,1,0,6,a
matrix,1,0,0,0,1,1,3,a
barrel bomb,3,0,0,0,3,1,7,a
lefty,2,0,0,0,2,0,4,a
im,5,0,6,0,4,8,23,a
secretary of state tillerson,2,0,0,0,0,1,3,a
sean spicer video,2,2,0,0,0,0,4,a
holocaust remarks,3,8,0,0,1,1,13,a
sheesh,1,0,1,0,0,2,4,a
trump news,1,0,0,0,1,1,3,a
knowγçö nazis used gas chambers,4,0,0,0,0,0,4,a
hitler gaffe causes uproar,2,0,0,0,0,2,4,a
fantastic,1,0,2,0,0,0,3,a
goonies,1,0,0,1,1,0,3,a
tfw alex jones,2,2,0,0,0,0,4,a
us eric trump,1,0,0,0,0,5,6,a
commander in chief,6,0,0,0,6,0,12,a
bears,1,0,0,0,1,1,3,a
middle class,1,0,0,0,1,1,3,a
reddit,1,0,0,0,1,1,3,a
pos,1,0,0,9,4,5,19,a
male number one,1,2,0,0,0,0,3,a
deplorables,1,0,0,0,1,1,3,a
racism,1,0,0,0,1,1,3,a
bet sean spicer,2,2,0,0,0,0,4,a
argues assad gassing worse,1,0,0,0,0,2,3,a
teamsters,1,0,2,0,0,0,3,a
hill,7,0,0,0,5,1,13,a
neil,1,0,0,0,0,4,5,a
tops,1,0,1,0,0,2,4,a
lieu,1,0,0,0,1,1,3,a
crooks,3,0,0,0,2,0,5,a
passover seder,1,2,0,1,1,0,5,a
weγçöre,4,7,2,0,0,0,13,a
thegoodgodabove,1,0,3,0,0,0,4,a
sean spicer's clarification,1,1,0,0,0,3,5,a
sean spicer slammed,2,2,0,0,0,0,4,a
bbg,0,0,0,1,0,2,3,a
trump's syria strike,2,2,0,0,0,2,6,a
liberal media,2,1,0,0,1,0,4,a
shutting,1,0,0,0,1,1,3,a
secretary of state rex tillerson,5,0,0,0,0,0,5,a
gizmodo,1,0,2,0,0,1,4,a
doesnγçöt,1,3,0,0,0,1,5,a
marketwatch,0,0,2,1,0,0,3,a
question of the day,3,0,0,0,1,0,4,a
comparing assad,1,3,0,0,0,1,5,a
uber,3,0,5,0,2,2,12,a
solves,4,0,0,0,3,1,8,a
youre,1,0,0,1,1,0,3,a
sees sean spicer,3,3,0,0,0,0,6,a
sean spicer justifies syria strike,4,0,0,0,0,0,4,a
communicator of the year,2,0,0,0,1,0,3,a
white house easter bunny,5,3,0,0,0,0,8,a
calls nepotism,2,0,0,0,2,0,4,a
jews on holocaust remembrance day,4,0,0,0,0,0,4,a
trump aide,5,15,0,0,1,3,24,a
united flights,1,2,0,0,0,0,3,a
western,6,0,2,0,5,0,13,a
mall,2,0,0,0,2,0,4,a
give mediocre white men microphones,3,0,0,0,0,0,3,a
russia prior,1,2,0,0,0,0,3,a
ffs,0,0,1,15,3,14,33,a
syria strikes,2,6,0,0,0,2,10,a
iγçöve,1,1,2,0,0,0,4,a
memo,1,0,0,0,1,2,4,a
mike,4,0,1,0,2,5,12,a
dybala,4,0,0,0,0,14,18,a
sean spicerγçös firing,4,6,0,0,0,0,10,a
north korea threatens,1,1,0,0,0,1,3,a
update,1,0,1,4,2,2,10,a
ba,0,0,0,1,0,2,3,a
man sean spicer,3,2,0,0,1,1,7,a
ap,0,0,0,3,1,1,5,a
world war,6,0,0,0,4,2,12,a
boom,6,0,2,7,4,19,38,a
sean spicer meant,4,4,0,0,0,1,9,a
sean spicer's mental health grows,3,0,0,0,0,0,3,a
sean spicer grovels,2,2,0,0,0,0,4,a
sam,2,0,0,0,2,0,4,a
clickhole,2,0,1,0,1,0,4,a
pt,1,0,0,0,1,6,8,a
sean spicer's history,1,2,0,0,0,0,3,a
chase,1,0,0,0,1,1,3,a
sean spicer credits hitler,4,0,0,0,0,4,8,a
wh easter bunny,2,3,0,0,0,0,5,a
constitutional,2,0,0,0,2,0,4,a
stock market,2,1,0,0,2,0,5,a
ellemagazine,1,0,2,0,0,0,3,a
gifs,2,0,0,0,1,2,5,a
peanuts,1,0,0,0,1,1,3,a
tower,3,0,0,0,2,0,5,a
ca,0,0,0,4,1,1,6,a
patience,2,0,0,0,2,0,4,a
satan,2,0,2,0,1,0,5,a
sean spicer show,2,3,0,0,0,1,6,a
spreading holocaust denial,2,2,0,0,0,3,7,a
polish death camps,0,0,0,1,0,2,3,a
spice,7,0,2,0,8,6,23,a
wmd,0,0,0,3,1,0,4,a
millions of americans,1,1,0,0,0,1,3,a
induced,1,0,0,0,1,1,3,a
nazi gas,1,2,0,0,0,0,3,a
sean spicer causes uproar,5,1,0,0,0,3,9,a
tiny,1,0,0,0,0,4,5,a
ah,4,0,12,2,1,7,26,a
6m,0,0,0,2,1,0,3,a
kabuki,2,0,1,0,1,0,4,a
issa,1,0,2,0,0,0,3,a
tarred,1,0,0,0,0,6,7,a
nastiest,0,0,0,4,1,0,5,a
eric trump may,2,3,0,0,0,2,7,a
ru,0,0,0,4,1,0,5,a
bull shit,1,1,0,1,1,0,4,a
holocaust center,64,40,0,1,25,20,150,a
ignorant sean spicer,1,2,0,0,0,0,3,a
chill,1,0,0,0,1,1,3,a
americas,3,0,0,0,2,0,5,a
robbing,0,0,0,1,0,2,3,a
candidate,cap,substring-cap,s-o-sCap,all-cap,non-cap,non-discriminative,cumulative,status
ask sean spicer,2,3,0,0,0,2,7,a
meals on wheels,2,2,0,0,1,0,5,a
agreed,2,0,2,1,2,3,10,a
republican,12,0,4,0,7,6,29,a
nazi death camps,3,5,0,0,0,0,8,a
senator,2,0,0,0,2,1,5,a
senators,2,0,0,0,2,1,5,a
ww1,0,0,0,4,1,0,5,a
devil,3,0,0,0,2,0,5,a
syria strike proves,11,9,0,0,0,6,26,a
clearance,1,0,0,0,1,2,4,a
record,2,0,0,0,2,0,4,a
apparently hitler,1,2,0,0,0,0,3,a
adminstration,2,0,0,0,2,0,4,a
bingo,3,0,0,0,3,0,6,a
thereγçös,1,2,1,0,0,0,4,a
hitler comparison,4,6,0,0,0,3,13,a
attack on syria,2,2,0,0,0,0,4,a
syria strike,18,48,0,0,0,6,72,a
united ceo oscar munoz,3,0,0,1,0,1,5,a
trump told,1,3,0,0,0,0,4,a
god,56,0,13,2,60,49,180,a
easter egg,0,1,0,0,0,5,6,a
whites,2,0,0,0,1,2,5,a
russia ties,11,29,0,0,1,7,48,a
sean spicer draws backlash,49,0,0,0,0,24,73,a
literally hitler,1,7,0,1,0,8,17,a
sob,1,0,0,2,2,1,6,a
press secretary sean spicer,48,11,0,0,0,9,68,a
measured,2,0,0,0,2,0,4,a
eric trump admits,4,4,0,0,0,2,10,a
bye bye,2,2,0,0,1,3,8,a
reaccomodated,2,0,0,0,2,0,4,a
pepsi ad,1,2,0,0,0,1,4,a
junior,3,0,2,0,2,1,8,a
cillizza,8,0,18,0,0,0,26,a
soldier,3,0,0,0,2,0,5,a
missile strike in syria,5,2,0,0,0,1,8,a
don the con,3,3,0,1,0,0,7,a
big win,1,0,0,0,1,3,5,a
daughter ivanka,2,3,0,0,0,4,9,a
pops,2,0,0,0,2,0,4,a
your fired,1,0,0,0,1,1,3,a
sean spicer's false claim,2,0,0,0,0,1,3,a
woah,1,0,1,0,0,3,5,a
jesus,11,0,17,0,1,23,52,a
civil rights,1,0,0,0,1,1,3,a
welp,2,0,3,0,0,7,12,a
jr,12,0,1,1,8,2,24,a
watching sean spicer,8,14,0,0,1,1,24,a
eff,1,0,0,0,1,1,3,a
asshats,1,0,0,0,1,1,3,a
white people,1,0,0,0,1,1,3,a
sean spicer barca,3,0,0,0,0,7,10,a
maga,0,0,0,7,3,2,12,a
defended hitler,1,3,0,0,0,12,16,a
god bless,2,3,0,0,0,1,6,a
swing,2,0,1,0,1,3,7,a
leftists,7,0,5,0,5,10,27,a
opposition,2,0,0,0,2,2,6,a
employment,2,0,0,0,2,1,5,a
jewish holiday,1,3,0,0,0,1,5,a
hitler comment,19,32,0,1,0,14,66,a
yesterday pepsi,1,3,0,0,0,0,4,a
billion,11,0,0,1,8,0,20,a
fire spicer,6,7,0,0,1,3,17,a
sean spicer apologizes,27,46,0,0,0,27,100,a
make america great again,3,2,0,1,0,0,6,a
ww3,0,0,0,19,8,0,27,a
defending hitler on passover,2,1,0,0,0,2,5,a
amen,1,0,0,1,2,5,9,a
drumpf,6,0,0,0,6,0,12,a
worldwide,1,0,0,1,1,1,4,a
corp,1,0,0,0,1,1,3,a
pants on fire,4,1,0,0,3,1,9,a
politifact,1,0,2,0,0,0,3,a
top 5,0,1,0,0,1,15,17,a
university,2,0,0,0,1,3,6,a
legal fisa,1,2,0,1,0,0,4,a
wh press secretary,5,8,0,0,0,1,14,a
goy,0,0,0,3,1,1,5,a
fbi fisa warrant,1,1,0,1,0,7,10,a
protecting,0,0,2,1,0,1,4,a
sister influenced presidentγçös decision,4,0,0,0,0,2,6,a
tfw,0,0,1,1,0,1,3,a
sale,1,0,0,0,1,2,4,a
pop,1,0,0,0,1,1,3,a
holocaust centre,6,4,0,0,4,3,17,a
holocaust gaffe,3,5,0,0,0,0,8,a
obama admin,1,3,0,0,0,1,5,a
impeach trump,1,2,0,0,0,1,4,a
jeff sessions lied,0,0,0,4,0,0,4,a
bullshit stunt,1,1,0,0,0,2,4,a
american government,1,2,0,0,0,0,3,a
flash,2,0,1,0,2,1,6,a
hitler remarks at press briefing,3,0,0,0,0,0,3,a
praises hitler,1,3,0,0,0,0,4,a
seder,10,0,0,0,9,1,20,a
feathered,1,0,0,0,0,6,7,a
sean spicer proves,2,2,0,0,0,0,4,a
say eric,1,2,0,0,0,0,3,a
tv,2,0,0,42,11,2,57,a
holo,1,0,0,0,1,1,3,a
objectivity,1,0,1,0,1,4,7,a
replace spicer,2,3,0,0,0,0,5,a
receipts,0,0,0,2,1,0,3,a
russian spy,3,9,0,1,0,2,15,a
scholar lawprof,1,0,0,0,0,6,7,a
generals,6,0,0,0,4,2,12,a
carter page met,1,2,0,0,0,1,4,a
obviously sean spicer,2,2,0,0,0,0,4,a
sean spicer falsely stated,1,0,0,0,0,2,3,a
white house press briefing,8,5,0,0,0,4,17,a
holocaust centers sean spicer,3,0,0,0,0,3,6,a
spent,4,0,1,0,4,0,9,a
disabled germans,1,2,0,0,0,0,3,a
fire trump,1,3,0,0,0,1,5,a
social studies,1,0,0,0,1,1,3,a
sean spicer went on cnn,3,0,0,0,0,0,3,a
jim,2,0,0,0,1,3,6,a
whoops,1,0,2,0,0,0,3,a
making america,2,3,0,0,0,0,5,a
sa,0,0,0,4,1,0,5,a
jews gassed,1,2,0,0,0,0,3,a
really sean spicer,1,1,0,0,0,3,5,a
meet in moscow on weekend,3,0,0,0,0,0,3,a
us government,1,2,0,0,0,0,3,a
safe zones,1,0,0,0,1,1,3,a
save sean spicer,2,2,0,0,0,2,6,a
bff,0,0,0,2,1,0,3,a
anne frank center calling,2,1,0,0,0,0,3,a
says ivanka,1,2,0,0,0,0,3,a
bannon in the white house,3,0,0,0,0,0,3,a
breaking,5,0,10,43,19,22,99,a
trumprussia,4,1,1,0,2,1,9,a
wag the dog,3,0,0,0,3,3,9,a
fo,0,0,0,2,1,0,3,a
stooges,2,0,0,0,2,0,4,a
court jester,3,0,0,0,3,0,6,a
gas jews,3,6,0,0,0,0,9,a
exclusive,2,0,3,0,1,0,6,a
matrix,1,0,0,0,1,1,3,a
barrel bomb,3,0,0,0,3,1,7,a
lefty,2,0,0,0,2,0,4,a
im,5,0,6,0,4,8,23,a
secretary of state tillerson,2,0,0,0,0,1,3,a
sean spicer video,2,2,0,0,0,0,4,a
trump news,1,0,0,0,1,1,3,a
knowγçö nazis used gas chambers,4,0,0,0,0,0,4,a
hitler gaffe causes uproar,2,0,0,0,0,2,4,a
fantastic,1,0,2,0,0,0,3,a
goonies,1,0,0,1,1,0,3,a
tfw alex jones,2,2,0,0,0,0,4,a
us eric trump,1,0,0,0,0,5,6,a
commander in chief,6,0,0,0,6,0,12,a
bears,1,0,0,0,1,1,3,a
middle class,1,0,0,0,1,1,3,a
reddit,1,0,0,0,1,1,3,a
pos,1,0,0,9,4,5,19,a
deplorables,1,0,0,0,1,1,3,a
racism,1,0,0,0,1,1,3,a
bet sean spicer,2,2,0,0,0,0,4,a
argues assad gassing worse,1,0,0,0,0,2,3,a
teamsters,1,0,2,0,0,0,3,a
hill,7,0,0,0,5,1,13,a
neil,1,0,0,0,0,4,5,a
tops,1,0,1,0,1,2,5,a
lieu,1,0,0,0,1,1,3,a
crooks,3,0,0,0,2,0,5,a
passover seder,1,2,0,1,1,0,5,a
weγçöre,4,7,2,0,0,0,13,a
thegoodgodabove,1,0,3,0,0,0,4,a
sean spicer's clarification,1,1,0,0,0,3,5,a
sean spicer slammed,2,2,0,0,0,0,4,a
bbg,0,0,0,1,0,2,3,a
trump's syria strike,2,2,0,0,0,2,6,a
liberal media,2,1,0,0,1,0,4,a
shutting,1,0,0,0,1,1,3,a
secretary of state rex tillerson,5,0,0,0,0,0,5,a
gizmodo,1,0,2,0,0,1,4,a
doesnγçöt,1,3,0,0,0,1,5,a
marketwatch,0,0,2,1,0,0,3,a
question of the day,3,0,0,0,1,0,4,a
comparing assad,1,3,0,0,0,1,5,a
uber,3,0,5,0,2,2,12,a
bother,1,0,0,1,1,0,3,a
solves,4,0,0,0,3,1,8,a
youre,1,0,0,1,1,0,3,a
sees sean spicer,3,3,0,0,0,0,6,a
sean spicer justifies syria strike,4,0,0,0,0,0,4,a
communicator of the year,2,0,0,0,1,0,3,a
white house easter bunny,5,3,0,0,0,0,8,a
calls nepotism,2,0,0,0,2,0,4,a
jews on holocaust remembrance day,4,0,0,0,0,0,4,a
united flights,1,2,0,0,0,0,3,a
western,6,0,2,0,5,0,13,a
give mediocre white men microphones,3,0,0,0,0,0,3,a
russia prior,1,2,0,0,0,0,3,a
ffs,0,0,1,15,3,14,33,a
syria strikes,2,6,0,0,0,2,10,a
hitler comments,6,24,0,0,0,13,43,a
iγçöve,1,1,2,0,0,0,4,a
memo,1,0,0,0,1,2,4,a
mike,4,0,1,0,2,5,12,a
sean spicerγçös firing,4,6,0,0,0,0,10,a
north korea threatens,1,1,0,0,0,1,3,a
update,1,0,1,4,2,2,10,a
ba,0,0,0,1,0,2,3,a
man sean spicer,3,2,0,0,1,1,7,a
ap,0,0,0,3,1,1,5,a
boom,6,0,2,7,4,19,38,a
sean spicer meant,4,5,0,0,0,1,10,a
sean spicer's mental health grows,3,0,0,0,0,0,3,a
sean spicer grovels,2,2,0,0,0,0,4,a
sam,2,0,0,0,2,0,4,a
clickhole,2,0,1,0,1,0,4,a
pt,1,0,0,0,1,6,8,a
chase,1,0,0,0,1,1,3,a
sean spicer credits hitler,4,0,0,0,0,4,8,a
wh easter bunny,2,3,0,0,0,0,5,a
constitutional,2,0,0,0,2,0,4,a
stock market,2,1,0,0,2,0,5,a
ellemagazine,1,0,2,0,0,0,3,a
gifs,2,0,0,0,1,2,5,a
peanuts,1,0,0,0,1,1,3,a
tower,3,0,0,0,2,0,5,a
ca,0,0,0,4,1,1,6,a
patience,2,0,0,0,2,0,4,a
satan,2,0,2,0,1,0,5,a
sean spicer show,2,3,0,0,0,0,5,a
spreading holocaust denial,2,2,0,0,0,3,7,a
polish death camps,0,0,0,1,0,2,3,a
wmd,0,0,0,3,1,0,4,a
millions of americans,1,1,0,0,0,1,3,a
nazi gas,1,2,0,0,0,0,3,a
sean spicer causes uproar,5,1,0,0,0,3,9,a
ah,4,0,12,2,1,7,26,a
6m,0,0,0,2,1,0,3,a
kabuki,2,0,1,0,1,0,4,a
issa,1,0,2,0,0,0,3,a
tarred,1,0,0,0,0,6,7,a
nastiest,0,0,0,4,1,0,5,a
eric trump may,2,3,0,0,0,1,6,a
ru,0,0,0,4,1,0,5,a
bull shit,1,1,0,1,1,0,4,a
americas,3,0,0,0,2,0,5,a
robbing,0,0,0,1,0,2,3,a
candidate,cap,substring-cap,s-o-sCap,all-cap,non-cap,non-discriminative,cumulative,status
ask sean spicer,2,4,0,0,0,2,8,a
meals on wheels,2,2,0,0,1,0,5,a
republican,12,0,4,0,7,6,29,a
nazi death camps,3,5,0,0,0,0,8,a
senator,2,0,0,0,2,1,5,a
senators,2,0,0,0,2,1,5,a
ww1,0,0,0,4,1,0,5,a
devil,3,0,0,0,2,0,5,a
syria strike proves,11,9,0,0,0,6,26,a
clearance,1,0,0,0,1,2,4,a
record,2,0,0,0,2,0,4,a
white women,3,3,0,0,3,1,10,a
apparently hitler,1,2,0,0,0,0,3,a
adminstration,2,0,0,0,2,0,4,a
allied,1,0,0,0,1,1,3,a
bingo,3,0,0,0,3,0,6,a
thereγçös,1,2,1,0,0,0,4,a
hitler comparison,4,6,0,0,0,3,13,a
attack on syria,2,2,0,0,0,0,4,a
syria strike,18,48,0,0,0,6,72,a
united ceo oscar munoz,3,0,0,1,0,1,5,a
trump told,1,3,0,0,0,0,4,a
god,56,0,13,2,60,49,180,a
easter egg,0,1,0,0,0,5,6,a
russia ties,11,29,0,0,1,7,48,a
sean spicer draws backlash,49,0,0,0,0,24,73,a
literally hitler,1,7,0,1,0,8,17,a
sob,1,0,0,2,2,1,6,a
press secretary sean spicer,48,11,0,0,0,9,68,a
measured,2,0,0,0,2,0,4,a
eric trump admits,4,4,0,0,0,2,10,a
bye bye,2,2,0,0,1,3,8,a
reaccomodated,2,0,0,0,2,0,4,a
pepsi ad,1,2,0,0,0,1,4,a
junior,3,0,2,0,2,1,8,a
cillizza,8,0,18,0,0,0,26,a
soldier,3,0,0,0,2,0,5,a
missile strike in syria,5,2,0,0,0,1,8,a
don the con,3,3,0,1,0,0,7,a
big win,1,0,0,0,1,3,5,a
daughter ivanka,2,3,0,0,0,4,9,a
pops,2,0,0,0,2,0,4,a
press secretary sean,1,2,0,0,0,0,3,a
your fired,1,0,0,0,1,1,3,a
sean spicer's false claim,2,0,0,0,0,1,3,a
woah,1,0,1,0,0,3,5,a
obstruction,1,0,2,0,1,2,6,a
jesus,11,0,17,0,1,23,52,a
civil rights,1,0,0,0,1,1,3,a
welp,2,0,3,0,0,7,12,a
jr,12,0,1,1,8,2,24,a
watching sean spicer,8,14,0,0,1,1,24,a
eff,1,0,0,0,1,1,3,a
asshats,1,0,0,0,1,1,3,a
white people,1,0,0,0,1,1,3,a
sean spicer barca,3,0,0,0,0,7,10,a
eric trump proves,1,2,0,0,0,0,3,a
maga,0,0,0,7,3,2,12,a
defended hitler,1,3,0,0,0,12,16,a
god bless,2,3,0,0,0,1,6,a
swing,2,0,1,0,1,3,7,a
leftists,7,0,5,0,5,10,27,a
opposition,2,0,0,0,2,2,6,a
employment,2,0,0,0,2,1,5,a
jewish holiday,1,3,0,0,0,1,5,a
hitler comment,19,32,0,1,0,14,66,a
yesterday pepsi,1,3,0,0,0,0,4,a
sean spicer holocaust centers,8,1,0,0,0,25,34,a
billion,11,0,0,1,9,0,21,a
fire spicer,6,7,0,0,1,3,17,a
sean spicer apologizes,27,46,0,0,0,27,100,a
make america great again,3,2,0,1,0,0,6,a
progressives,2,0,1,0,2,0,5,a
ww3,0,0,0,19,8,0,27,a
defending hitler on passover,2,1,0,0,0,2,5,a
amen,1,0,0,1,2,5,9,a
drumpf,6,0,0,0,6,0,12,a
watched sean spicer,1,2,0,0,0,0,3,a
worldwide,1,0,0,1,1,1,4,a
corp,1,0,0,0,1,1,3,a
pants on fire,4,1,0,0,3,1,9,a
politifact,1,0,2,0,0,0,3,a
top 5,0,1,0,0,1,15,17,a
university,2,0,0,0,1,3,6,a
legal fisa,1,2,0,1,0,0,4,a
wh press secretary,5,8,0,0,0,1,14,a
goy,0,0,0,3,1,1,5,a
guess sean spicer,1,2,0,0,0,0,3,a
fbi fisa warrant,1,1,0,1,0,7,10,a
protecting,0,0,2,1,0,1,4,a
sister influenced presidentγçös decision,4,0,0,0,0,2,6,a
tfw,0,0,1,1,0,1,3,a
sale,1,0,0,0,1,2,4,a
pop,1,0,0,0,1,1,3,a
holocaust centre,6,4,0,0,4,3,17,a
holocaust gaffe,3,5,0,0,0,0,8,a
obama admin,1,3,0,0,0,1,5,a
impeach trump,1,2,0,0,0,1,4,a
jeff sessions lied,0,0,0,4,0,0,4,a
bullshit stunt,1,1,0,0,0,2,4,a
american government,1,2,0,0,0,0,3,a
flash,2,0,1,0,2,1,6,a
hitler remarks at press briefing,3,0,0,0,0,0,3,a
praises hitler,1,3,0,0,0,0,4,a
seder,10,0,0,0,9,1,20,a
feathered,1,0,0,0,0,6,7,a
sean spicer proves,2,2,0,0,0,0,4,a
say eric,1,2,0,0,0,0,3,a
tv,2,0,0,42,11,2,57,a
holo,1,0,0,0,1,1,3,a
objectivity,1,0,1,0,1,4,7,a
replace spicer,2,3,0,0,0,0,5,a
getting a fisa,1,2,0,0,0,0,3,a
receipts,0,0,0,2,1,0,3,a
russian spy,3,9,0,1,0,2,15,a
regarding sean spicer,1,2,0,0,0,0,3,a
scholar lawprof,1,0,0,0,0,6,7,a
heγçös,2,7,0,0,0,0,9,a
generals,6,0,0,0,4,2,12,a
carter page met,1,2,0,0,0,1,4,a
obviously sean spicer,2,2,0,0,0,0,4,a
tf,0,0,1,7,4,1,13,a
sean spicer falsely stated,1,0,0,0,0,2,3,a
white house press briefing,8,5,0,0,0,4,17,a
holocaust centers sean spicer,3,0,0,0,0,3,6,a
spent,4,0,1,0,4,0,9,a
disabled germans,1,2,0,0,0,0,3,a
fire trump,1,3,0,0,0,1,5,a
social studies,1,0,0,0,1,1,3,a
sean spicer went on cnn,3,0,0,0,0,0,3,a
jim,2,0,0,0,1,3,6,a
tucker,1,0,0,0,1,1,3,a
whoops,1,0,2,0,0,0,3,a
making america,2,3,0,0,0,0,5,a
sa,0,0,0,4,1,0,5,a
jews gassed,1,2,0,0,0,0,3,a
really sean spicer,1,1,0,0,0,3,5,a
meet in moscow on weekend,3,0,0,0,0,0,3,a
us government,1,2,0,0,0,0,3,a
safe zones,1,0,0,0,1,1,3,a
save sean spicer,2,2,0,0,0,2,6,a
bff,0,0,0,2,1,0,3,a
anne frank center calling,2,1,0,0,0,0,3,a
says ivanka,1,2,0,0,0,0,3,a
bannon in the white house,3,0,0,0,0,0,3,a
breaking,5,0,10,43,19,22,99,a
trumprussia,4,1,1,0,2,1,9,a
wag the dog,3,0,0,0,3,3,9,a
fo,0,0,0,2,1,0,3,a
stooges,2,0,0,0,2,0,4,a
court jester,3,0,0,0,3,0,6,a
gas jews,3,6,0,0,0,0,9,a
exclusive,2,0,3,0,1,0,6,a
matrix,1,0,0,0,1,1,3,a
barrel bomb,3,0,0,0,3,1,7,a
lefty,2,0,0,0,2,0,4,a
im,5,0,6,0,4,8,23,a
secretary of state tillerson,2,0,0,0,0,1,3,a
sean spicer video,2,2,0,0,0,0,4,a
holocaust remarks,3,8,0,0,1,1,13,a
trump news,1,0,0,0,1,1,3,a
knowγçö nazis used gas chambers,4,0,0,0,0,0,4,a
hitler gaffe causes uproar,2,0,0,0,0,2,4,a
fantastic,1,0,2,0,0,0,3,a
goonies,1,0,0,1,1,0,3,a
tfw alex jones,2,2,0,0,0,0,4,a
us eric trump,1,0,0,0,0,5,6,a
commander in chief,6,0,0,0,6,0,12,a
bears,1,0,0,0,1,1,3,a
middle class,1,0,0,0,1,1,3,a
reddit,1,0,0,0,1,1,3,a
pos,1,0,0,9,4,5,19,a
male number one,1,2,0,0,0,0,3,a
deplorables,1,0,0,0,1,1,3,a
racism,1,0,0,0,1,1,3,a
bet sean spicer,2,2,0,0,0,0,4,a
argues assad gassing worse,1,0,0,0,0,2,3,a
teamsters,1,0,2,0,0,0,3,a
hill,7,0,0,0,5,1,13,a
neil,1,0,0,0,0,4,5,a
tops,1,0,1,0,1,2,5,a
lieu,1,0,0,0,1,1,3,a
crooks,3,0,0,0,2,0,5,a
passover seder,1,2,0,1,1,0,5,a
rally,3,0,1,0,2,0,6,a
weγçöre,4,7,2,0,0,0,13,a
thegoodgodabove,1,0,3,0,0,0,4,a
sean spicer's clarification,1,1,0,0,0,3,5,a
sean spicer slammed,2,2,0,0,0,0,4,a
bbg,0,0,0,1,0,2,3,a
trump's syria strike,2,2,0,0,0,2,6,a
liberal media,2,1,0,0,1,0,4,a
shutting,1,0,0,0,1,1,3,a
secretary of state rex tillerson,5,0,0,0,0,0,5,a
gizmodo,1,0,2,0,0,1,4,a
doesnγçöt,1,3,0,0,0,1,5,a
marketwatch,0,0,2,1,0,0,3,a
question of the day,3,0,0,0,1,0,4,a
comparing assad,1,3,0,0,0,1,5,a
uber,3,0,5,0,2,2,12,a
bother,1,0,0,1,1,0,3,a
solves,4,0,0,0,3,1,8,a
youre,1,0,0,1,1,0,3,a
sees sean spicer,3,3,0,0,0,0,6,a
sean spicer justifies syria strike,4,0,0,0,0,0,4,a
communicator of the year,2,0,0,0,1,0,3,a
white house easter bunny,5,3,0,0,0,0,8,a
calls nepotism,2,0,0,0,2,0,4,a
jews on holocaust remembrance day,4,0,0,0,0,0,4,a
trump aide,5,15,0,0,1,3,24,a
united flights,1,2,0,0,0,0,3,a
western,6,0,2,0,5,0,13,a
give mediocre white men microphones,3,0,0,0,0,0,3,a
mike pence,2,1,0,0,1,0,4,a
russia prior,1,2,0,0,0,0,3,a
mention hitler,0,3,0,2,0,0,5,a
ffs,0,0,1,15,3,14,33,a
syria strikes,2,6,0,0,0,2,10,a
hitler comments,6,24,0,0,0,13,43,a
iγçöve,1,1,2,0,0,0,4,a
memo,1,0,0,0,1,2,4,a
mike,4,0,1,0,2,5,12,a
sean spicerγçös firing,4,6,0,0,0,0,10,a
north korea threatens,1,1,0,0,0,1,3,a
update,1,0,1,4,2,2,10,a
ba,0,0,0,1,0,2,3,a
man sean spicer,3,2,0,0,1,1,7,a
ap,0,0,0,3,1,1,5,a
boom,6,0,2,7,4,19,38,a
sean spicer meant,4,5,0,0,0,1,10,a
sean spicer's mental health grows,3,0,0,0,0,0,3,a
sean spicer grovels,2,2,0,0,0,0,4,a
sam,2,0,0,0,2,0,4,a
clickhole,2,0,1,0,1,0,4,a
pt,1,0,0,0,1,6,8,a
sean spicer's history,1,2,0,0,0,0,3,a
chase,1,0,0,0,1,1,3,a
sean spicer credits hitler,4,0,0,0,0,4,8,a
wh easter bunny,2,3,0,0,0,0,5,a
constitutional,2,0,0,0,2,0,4,a
stock market,2,1,0,0,2,0,5,a
ellemagazine,1,0,2,0,0,0,3,a
peanuts,1,0,0,0,1,1,3,a
tower,3,0,0,0,2,0,5,a
ca,0,0,0,4,1,1,6,a
stupid sean spicer,1,2,0,0,0,0,3,a
patience,2,0,0,0,2,0,4,a
satan,2,0,2,0,1,0,5,a
sean spicer show,2,3,0,0,0,0,5,a
spreading holocaust denial,2,2,0,0,0,3,7,a
polish death camps,0,0,0,1,0,2,3,a
spice,7,0,2,0,8,6,23,a
wmd,0,0,0,3,1,0,4,a
millions of americans,1,1,0,0,0,1,3,a
nazi gas,1,2,0,0,0,0,3,a
sean spicer causes uproar,5,1,0,0,0,3,9,a
ah,4,0,12,2,1,7,26,a
6m,0,0,0,2,1,0,3,a
kabuki,2,0,1,0,1,0,4,a
issa,1,0,2,0,0,0,3,a
tarred,1,0,0,0,0,6,7,a
nastiest,0,0,0,4,1,0,5,a
eric trump may,2,3,0,0,0,2,7,a
ru,0,0,0,4,1,0,5,a
bull shit,1,1,0,1,1,0,4,a
ignorant sean spicer,1,2,0,0,0,0,3,a
americas,3,0,0,0,2,0,5,a
robbing,0,0,0,1,0,2,3,a
candidate,cap,substring-cap,s-o-sCap,all-cap,non-cap,non-discriminative,cumulative,status
ask sean spicer,2,4,0,0,0,2,8,a
meals on wheels,2,2,0,0,1,0,5,a
republican,12,0,4,0,7,6,29,a
nazi death camps,3,5,0,0,0,0,8,a
senator,2,0,0,0,2,1,5,a
senators,2,0,0,0,2,1,5,a
ww1,0,0,0,4,1,0,5,a
devil,3,0,0,0,2,0,5,a
syria strike proves,11,9,0,0,0,6,26,a
clearance,1,0,0,0,1,2,4,a
record,2,0,0,0,2,0,4,a
apparently hitler,1,2,0,0,0,0,3,a
adminstration,2,0,0,0,2,0,4,a
allied,1,0,0,0,1,1,3,a
bingo,3,0,0,0,3,0,6,a
thereγçös,1,2,1,0,0,0,4,a
hitler comparison,4,7,0,0,0,3,14,a
attack on syria,2,2,0,0,0,0,4,a
syria strike,18,48,0,0,0,6,72,a
united ceo oscar munoz,3,0,0,1,0,1,5,a
trump told,1,3,0,0,0,0,4,a
god,56,0,13,2,60,49,180,a
easter egg,0,1,0,0,0,5,6,a
russia ties,11,29,0,0,1,7,48,a
sean spicer draws backlash,49,0,0,0,0,24,73,a
literally hitler,1,7,0,1,0,8,17,a
sob,1,0,0,2,2,1,6,a
press secretary sean spicer,48,11,0,0,0,9,68,a
measured,2,0,0,0,2,0,4,a
eric trump admits,4,4,0,0,0,2,10,a
bye bye,2,2,0,0,1,3,8,a
reaccomodated,2,0,0,0,2,0,4,a
pepsi ad,1,2,0,0,0,1,4,a
junior,3,0,2,0,2,1,8,a
cillizza,8,0,18,0,0,0,26,a
soldier,3,0,0,0,2,0,5,a
missile strike in syria,5,2,0,0,0,1,8,a
don the con,3,3,0,1,0,0,7,a
big win,1,0,0,0,1,3,5,a
daughter ivanka,2,3,0,0,0,4,9,a
pops,2,0,0,0,2,0,4,a
press secretary sean,1,2,0,0,0,0,3,a
your fired,1,0,0,0,1,1,3,a
sean spicer's false claim,2,0,0,0,0,1,3,a
woah,1,0,1,0,0,3,5,a
obstruction,1,0,2,0,1,2,6,a
jesus,11,0,17,0,1,23,52,a
civil rights,1,0,0,0,1,1,3,a
welp,2,0,3,0,0,7,12,a
jr,12,0,1,1,8,2,24,a
watching sean spicer,8,14,0,0,1,1,24,a
eff,1,0,0,0,1,1,3,a
asshats,1,0,0,0,1,1,3,a
martin,1,0,2,0,0,0,3,a
white people,1,0,0,0,1,1,3,a
eric trump proves,1,2,0,0,0,0,3,a
maga,0,0,0,7,3,2,12,a
defended hitler,1,3,0,0,0,12,16,a
god bless,2,3,0,0,0,1,6,a
swing,2,0,1,0,1,3,7,a
leftists,7,0,5,0,5,10,27,a
opposition,2,0,0,0,2,2,6,a
employment,2,0,0,0,2,1,5,a
jewish holiday,1,3,0,0,0,1,5,a
hitler comment,19,32,0,1,0,14,66,a
yesterday pepsi,1,3,0,0,0,0,4,a
billion,11,0,0,1,9,0,21,a
fire spicer,6,7,0,0,1,3,17,a
sean spicer apologizes,27,46,0,0,0,27,100,a
make america great again,3,2,0,1,0,0,6,a
progressives,2,0,1,0,2,0,5,a
ww3,0,0,0,19,8,0,27,a
defending hitler on passover,2,1,0,0,0,2,5,a
amen,1,0,0,1,2,5,9,a
drumpf,6,0,0,0,6,0,12,a
watched sean spicer,1,2,0,0,0,0,3,a
worldwide,1,0,0,1,1,1,4,a
corp,1,0,0,0,1,1,3,a
pants on fire,4,1,0,0,3,1,9,a
politifact,1,0,2,0,0,0,3,a
top 5,0,1,0,0,1,15,17,a
university,2,0,0,0,1,3,6,a
legal fisa,1,2,0,1,0,0,4,a
wh press secretary,5,8,0,0,0,1,14,a
goy,0,0,0,3,1,1,5,a
calls concentration camps,1,0,0,0,1,1,3,a
guess sean spicer,1,2,0,0,0,0,3,a
fbi fisa warrant,1,1,0,1,0,7,10,a
protecting,0,0,2,1,0,1,4,a
sister influenced presidentγçös decision,4,0,0,0,0,2,6,a
tfw,0,0,1,1,0,1,3,a
sale,1,0,0,0,1,2,4,a
pop,1,0,0,0,1,1,3,a
holocaust centre,6,4,0,0,4,3,17,a
holocaust gaffe,3,5,0,0,0,0,8,a
obama admin,1,3,0,0,0,1,5,a
impeach trump,1,2,0,0,0,1,4,a
jeff sessions lied,0,0,0,4,0,0,4,a
american government,1,2,0,0,0,0,3,a
flash,2,0,1,0,2,1,6,a
hitler remarks at press briefing,3,0,0,0,0,0,3,a
praises hitler,1,3,0,0,0,0,4,a
seder,10,0,0,0,9,1,20,a
feathered,1,0,0,0,0,6,7,a
sean spicer proves,2,2,0,0,0,0,4,a
say eric,1,2,0,0,0,0,3,a
holo,1,0,0,0,1,1,3,a
objectivity,1,0,1,0,1,4,7,a
replace spicer,2,3,0,0,0,0,5,a
getting a fisa,1,2,0,0,0,0,3,a
receipts,0,0,0,2,1,0,3,a
russian spy,3,9,0,1,0,2,15,a
regarding sean spicer,1,2,0,0,0,0,3,a
scholar lawprof,1,0,0,0,0,6,7,a
heγçös,2,7,0,0,0,0,9,a
generals,6,0,0,0,4,2,12,a
carter page met,1,2,0,0,0,1,4,a
obviously sean spicer,2,2,0,0,0,0,4,a
tf,0,0,1,7,4,1,13,a
sean spicer falsely stated,1,0,0,0,0,2,3,a
white house press briefing,8,5,0,0,0,3,16,a
holocaust centers sean spicer,3,0,0,0,0,3,6,a
spent,4,0,1,0,4,0,9,a
disabled germans,1,2,0,0,0,0,3,a
fire trump,1,3,0,0,0,1,5,a
social studies,1,0,0,0,1,1,3,a
sean spicer went on cnn,3,0,0,0,0,0,3,a
jim,2,0,0,0,1,3,6,a
tucker,1,0,0,0,1,1,3,a
making america,2,3,0,0,0,0,5,a
sa,0,0,0,4,1,0,5,a
jews gassed,1,2,0,0,0,0,3,a
really sean spicer,1,1,0,0,0,3,5,a
meet in moscow on weekend,3,0,0,0,0,0,3,a
us government,1,2,0,0,0,0,3,a
safe zones,1,0,0,0,1,1,3,a
save sean spicer,2,2,0,0,0,2,6,a
bff,0,0,0,2,1,0,3,a
anne frank center calling,2,1,0,0,0,0,3,a
says ivanka,1,2,0,0,0,0,3,a
bannon in the white house,3,0,0,0,0,0,3,a
breaking,5,0,10,43,19,22,99,a
trumprussia,4,1,1,0,2,1,9,a
wag the dog,3,0,0,0,3,3,9,a
fo,0,0,0,2,1,0,3,a
stooges,2,0,0,0,2,0,4,a
court jester,3,0,0,0,3,0,6,a
gas jews,3,6,0,0,0,0,9,a
exclusive,2,0,3,0,1,0,6,a
matrix,1,0,0,0,1,1,3,a
barrel bomb,3,0,0,0,3,1,7,a
lefty,2,0,0,0,2,0,4,a
im,5,0,6,0,4,8,23,a
secretary of state tillerson,2,0,0,0,0,3,5,a
sean spicer video,2,2,0,0,0,0,4,a
holocaust remarks,3,8,0,0,1,1,13,a
trump news,1,0,0,0,1,1,3,a
knowγçö nazis used gas chambers,4,0,0,0,0,0,4,a
hitler gaffe causes uproar,2,0,0,0,0,2,4,a
fantastic,1,0,2,0,0,0,3,a
goonies,1,0,0,1,1,0,3,a
tfw alex jones,2,2,0,0,0,0,4,a
us eric trump,1,0,0,0,0,5,6,a
commander in chief,6,0,0,0,6,0,12,a
bears,1,0,0,0,1,1,3,a
middle class,1,0,0,0,1,1,3,a
reddit,1,0,0,0,1,1,3,a
pos,1,0,0,9,4,5,19,a
male number one,1,2,0,0,0,0,3,a
deplorables,1,0,0,0,1,1,3,a
bet sean spicer,2,2,0,0,0,0,4,a
argues assad gassing worse,1,0,0,0,0,2,3,a
stars,2,0,0,0,2,0,4,a
teamsters,1,0,2,0,0,0,3,a
hill,7,0,0,0,5,1,13,a
tops,1,0,1,0,1,2,5,a
lieu,1,0,0,0,1,1,3,a
crooks,3,0,0,0,2,0,5,a
passover seder,1,2,0,1,1,0,5,a
weγçöre,4,7,2,0,0,0,13,a
thegoodgodabove,1,0,3,0,0,0,4,a
sean spicer's clarification,1,1,0,0,0,3,5,a
sean spicer slammed,2,2,0,0,0,0,4,a
bbg,0,0,0,1,0,2,3,a
trump's syria strike,2,2,0,0,0,2,6,a
shutting,1,0,0,0,1,1,3,a
secretary of state rex tillerson,5,0,0,0,0,0,5,a
gizmodo,1,0,2,0,0,1,4,a
doesnγçöt,1,3,0,0,0,1,5,a
marketwatch,0,0,2,1,0,0,3,a
question of the day,3,0,0,0,1,0,4,a
comparing assad,1,3,0,0,0,1,5,a
uber,3,0,5,0,2,2,12,a
bother,1,0,0,1,1,0,3,a
solves,4,0,0,0,3,1,8,a
youre,1,0,0,1,1,0,3,a
sees sean spicer,3,3,0,0,0,0,6,a
sean spicer justifies syria strike,4,0,0,0,0,0,4,a
communicator of the year,2,0,0,0,1,0,3,a
white house easter bunny,5,3,0,0,0,0,8,a
calls nepotism,2,0,0,0,2,0,4,a
jews on holocaust remembrance day,4,0,0,0,0,0,4,a
trump aide,5,15,0,0,1,3,24,a
united flights,1,2,0,0,0,0,3,a
western,6,0,2,0,5,0,13,a
give mediocre white men microphones,3,0,0,0,0,0,3,a
russia prior,1,2,0,0,0,0,3,a
ffs,0,0,1,15,3,14,33,a
syria strikes,2,6,0,0,0,2,10,a
hitler comments,6,24,0,0,0,13,43,a
iγçöve,1,1,2,0,0,0,4,a
memo,1,0,0,0,1,2,4,a
mike,4,0,1,0,2,5,12,a
sean spicerγçös firing,4,6,0,0,0,0,10,a
north korea threatens,1,1,0,0,0,1,3,a
update,1,0,1,4,2,2,10,a
ba,0,0,0,1,0,2,3,a
man sean spicer,3,2,0,0,1,1,7,a
ap,0,0,0,3,1,1,5,a
boom,6,0,2,7,4,19,38,a
sean spicer meant,4,5,0,0,0,1,10,a
sean spicer's mental health grows,3,0,0,0,0,0,3,a
sean spicer grovels,2,2,0,0,0,0,4,a
sam,2,0,0,0,2,0,4,a
clickhole,2,0,1,0,1,0,4,a
pt,1,0,0,0,1,6,8,a
sean spicer's history,1,2,0,0,0,0,3,a
chase,1,0,0,0,1,1,3,a
sean spicer credits hitler,4,0,0,0,0,4,8,a
wh easter bunny,2,3,0,0,0,0,5,a
constitutional,2,0,0,0,2,0,4,a
stock market,2,1,0,0,2,0,5,a
ellemagazine,1,0,2,0,0,0,3,a
peanuts,1,0,0,0,1,1,3,a
tower,3,0,0,0,2,0,5,a
ca,0,0,0,4,1,1,6,a
stupid sean spicer,1,2,0,0,0,0,3,a
patience,2,0,0,0,2,0,4,a
satan,2,0,2,0,1,0,5,a
sean spicer show,2,3,0,0,0,0,5,a
spreading holocaust denial,2,2,0,0,0,3,7,a
polish death camps,0,0,0,1,0,2,3,a
spice,7,0,2,0,8,6,23,a
wmd,0,0,0,3,1,0,4,a
millions of americans,1,1,0,0,0,1,3,a
nazi gas,1,2,0,0,0,0,3,a
sean spicer causes uproar,5,1,0,0,0,3,9,a
ah,4,0,12,2,1,7,26,a
6m,0,0,0,2,1,0,3,a
kabuki,2,0,1,0,1,0,4,a
issa,1,0,2,0,0,0,3,a
tarred,1,0,0,0,0,6,7,a
nastiest,0,0,0,4,1,0,5,a
eric trump may,2,3,0,0,0,2,7,a
ru,0,0,0,4,1,0,5,a
bull shit,1,1,0,1,1,0,4,a
ignorant sean spicer,1,2,0,0,0,0,3,a
americas,3,0,0,0,2,0,5,a
robbing,0,0,0,1,0,2,3,a
candidate,cap,substring-cap,s-o-sCap,all-cap,non-cap,non-discriminative,cumulative,status
ask sean spicer,2,4,0,0,0,2,8,a
meals on wheels,2,2,0,0,1,0,5,a
republican,12,0,4,0,7,6,29,a
nazi death camps,3,5,0,0,0,0,8,a
senator,2,0,0,0,2,1,5,a
senators,2,0,0,0,2,1,5,a
ww1,0,0,0,4,1,0,5,a
devil,3,0,0,0,2,0,5,a
syria strike proves,11,9,0,0,0,6,26,a
clearance,1,0,0,0,1,2,4,a
record,2,0,0,0,2,0,4,a
white women,3,3,0,0,3,1,10,a
apparently hitler,1,2,0,0,0,0,3,a
adminstration,2,0,0,0,2,0,4,a
allied,1,0,0,0,1,1,3,a
bingo,3,0,0,0,3,0,6,a
thereγçös,1,2,1,0,0,0,4,a
hitler comparison,4,8,0,0,0,3,15,a
attack on syria,2,2,0,0,0,0,4,a
syria strike,18,48,0,0,0,6,72,a
united ceo oscar munoz,3,0,0,1,0,1,5,a
trump told,1,3,0,0,0,0,4,a
god,56,0,13,2,60,49,180,a
easter egg,0,1,0,0,0,5,6,a
russia ties,11,29,0,0,1,7,48,a
sean spicer draws backlash,49,0,0,0,0,24,73,a
literally hitler,1,7,0,1,0,8,17,a
sob,1,0,0,2,2,1,6,a
press secretary sean spicer,48,11,0,0,0,9,68,a
measured,2,0,0,0,2,0,4,a
eric trump admits,4,4,0,0,0,2,10,a
bye bye,2,2,0,0,1,3,8,a
pr stunt,1,4,0,0,0,1,6,a
reaccomodated,2,0,0,0,2,0,4,a
pepsi ad,1,2,0,0,0,1,4,a
junior,3,0,2,0,2,1,8,a
cillizza,8,0,18,0,0,0,26,a
us history,1,4,0,0,0,1,6,a
soldier,3,0,0,0,2,0,5,a
missile strike in syria,5,2,0,0,0,1,8,a
don the con,3,3,0,1,0,0,7,a
big win,1,0,0,0,1,3,5,a
daughter ivanka,2,3,0,0,0,4,9,a
pops,2,0,0,0,2,0,4,a
press secretary sean,1,2,0,0,0,0,3,a
your fired,1,0,0,0,1,1,3,a
sean spicer's false claim,2,0,0,0,0,1,3,a
woah,1,0,1,0,0,3,5,a
obstruction,1,0,2,0,1,2,6,a
jesus,11,0,17,0,1,23,52,a
civil rights,1,0,0,0,1,1,3,a
welp,2,0,3,0,0,7,12,a
jr,12,0,1,1,8,2,24,a
watching sean spicer,8,14,0,0,1,1,24,a
eff,1,0,0,0,1,1,3,a
asshats,1,0,0,0,1,1,3,a
martin,1,0,2,0,0,0,3,a
white people,1,0,0,0,1,1,3,a
eric trump proves,1,2,0,0,0,0,3,a
maga,0,0,0,7,3,2,12,a
defended hitler,1,3,0,0,0,12,16,a
god bless,2,3,0,0,0,1,6,a
swing,2,0,1,0,1,3,7,a
leftists,7,0,5,0,5,10,27,a
opposition,2,0,0,0,2,2,6,a
employment,2,0,0,0,2,1,5,a
jewish holiday,1,3,0,0,0,1,5,a
hitler comment,19,32,0,1,0,14,66,a
yesterday pepsi,1,3,0,0,0,0,4,a
sean spicer holocaust centers,8,1,0,0,0,25,34,a
billion,11,0,0,1,9,0,21,a
fire spicer,6,7,0,0,1,3,17,a
sean spicer apologizes,27,46,0,0,0,27,100,a
make america great again,3,2,0,1,0,0,6,a
progressives,2,0,1,0,2,0,5,a
ww3,0,0,0,19,8,0,27,a
defending hitler on passover,2,1,0,0,0,2,5,a
amen,1,0,0,1,2,5,9,a
drumpf,6,0,0,0,6,0,12,a
watched sean spicer,1,2,0,0,0,0,3,a
worldwide,1,0,0,1,1,1,4,a
corp,1,0,0,0,1,1,3,a
pants on fire,4,1,0,0,3,1,9,a
politifact,1,0,2,0,0,0,3,a
top 5,0,1,0,0,1,15,17,a
university,2,0,0,0,1,3,6,a
legal fisa,1,2,0,1,0,0,4,a
wh press secretary,5,8,0,0,0,1,14,a
goy,0,0,0,3,1,1,5,a
calls concentration camps,1,0,0,0,1,1,3,a
guess sean spicer,1,2,0,0,0,0,3,a
fbi fisa warrant,1,1,0,1,0,7,10,a
protecting,0,0,2,1,0,1,4,a
sister influenced presidentγçös decision,4,0,0,0,0,2,6,a
tfw,0,0,1,1,0,1,3,a
sale,1,0,0,0,1,2,4,a
pop,1,0,0,0,1,1,3,a
holocaust centre,6,4,0,0,4,3,17,a
holocaust gaffe,3,5,0,0,0,0,8,a
obama admin,1,3,0,0,0,1,5,a
impeach trump,1,2,0,0,0,1,4,a
jeff sessions lied,0,0,0,4,0,0,4,a
american government,1,2,0,0,0,0,3,a
flash,2,0,1,0,2,1,6,a
hitler remarks at press briefing,3,0,0,0,0,0,3,a
praises hitler,1,3,0,0,0,0,4,a
seder,10,0,0,0,9,1,20,a
feathered,1,0,0,0,0,6,7,a
sean spicer proves,2,2,0,0,0,0,4,a
say eric,1,2,0,0,0,0,3,a
tv,2,0,0,42,11,2,57,a
blonde,1,0,1,0,1,0,3,a
wikipedia,1,0,1,0,1,0,3,a
holo,1,0,0,0,1,1,3,a
objectivity,1,0,1,0,1,4,7,a
replace spicer,2,3,0,0,0,0,5,a
getting a fisa,1,2,0,0,0,0,3,a
receipts,0,0,0,2,1,0,3,a
russian spy,3,9,0,1,0,2,15,a
regarding sean spicer,1,2,0,0,0,0,3,a
scholar lawprof,1,0,0,0,0,6,7,a
heγçös,2,7,0,0,0,0,9,a
generals,6,0,0,0,4,2,12,a
carter page met,1,2,0,0,0,1,4,a
obviously sean spicer,2,2,0,0,0,0,4,a
tf,0,0,1,7,4,1,13,a
sean spicer falsely stated,1,0,0,0,0,2,3,a
white house press briefing,8,5,0,0,0,4,17,a
holocaust centers sean spicer,3,0,0,0,0,3,6,a
subtlety,1,0,1,0,1,0,3,a
spent,4,0,1,0,4,0,9,a
disabled germans,1,2,0,0,0,0,3,a
fire trump,1,3,0,0,0,1,5,a
yelp,1,0,1,0,1,0,3,a
social studies,1,0,0,0,1,1,3,a
sean spicer went on cnn,3,0,0,0,0,0,3,a
jim,2,0,0,0,1,3,6,a
tucker,1,0,0,0,1,1,3,a
making america,2,3,0,0,0,0,5,a
sa,0,0,0,4,1,0,5,a
jews gassed,1,2,0,0,0,0,3,a
really sean spicer,1,1,0,0,0,3,5,a
meet in moscow on weekend,3,0,0,0,0,0,3,a
us government,1,2,0,0,0,0,3,a
safe zones,1,0,0,0,1,1,3,a
save sean spicer,2,2,0,0,0,2,6,a
bff,0,0,0,2,1,0,3,a
anne frank center calling,2,1,0,0,0,0,3,a
says ivanka,1,2,0,0,0,0,3,a
bannon in the white house,3,0,0,0,0,0,3,a
breaking,5,0,10,43,19,22,99,a
trumprussia,4,1,1,0,2,1,9,a
wag the dog,3,0,0,0,3,3,9,a
fo,0,0,0,2,1,0,3,a
stooges,2,0,0,0,2,0,4,a
court jester,3,0,0,0,3,0,6,a
gas jews,3,6,0,0,0,0,9,a
exclusive,2,0,3,0,1,0,6,a
matrix,1,0,0,0,1,1,3,a
barrel bomb,3,0,0,0,3,1,7,a
lefty,2,0,0,0,2,0,4,a
warriors,1,0,1,0,1,0,3,a
im,5,0,6,0,4,8,23,a
secretary of state tillerson,2,0,0,0,0,3,5,a
sean spicer video,2,2,0,0,0,0,4,a
holocaust remarks,3,8,0,0,1,1,13,a
trump news,1,0,0,0,1,1,3,a
good god,2,8,0,0,1,7,18,a
knowγçö nazis used gas chambers,4,0,0,0,0,0,4,a
hitler gaffe causes uproar,2,0,0,0,0,2,4,a
fantastic,1,0,2,0,0,0,3,a
goonies,1,0,0,1,1,0,3,a
tfw alex jones,2,2,0,0,0,0,4,a
us eric trump,1,0,0,0,0,5,6,a
commander in chief,6,0,0,0,6,0,12,a
how'd,1,0,1,0,1,0,3,a
bears,1,0,0,0,1,1,3,a
middle class,1,0,0,0,1,1,3,a
reddit,1,0,0,0,1,1,3,a
pos,1,0,0,9,4,5,19,a
male number one,1,2,0,0,0,0,3,a
deplorables,1,0,0,0,1,1,3,a
bet sean spicer,2,2,0,0,0,0,4,a
argues assad gassing worse,1,0,0,0,0,2,3,a
stars,2,0,0,0,2,0,4,a
teamsters,1,0,2,0,0,0,3,a
hill,7,0,0,0,5,1,13,a
neil,1,0,0,0,0,4,5,a
tops,1,0,1,0,1,2,5,a
lieu,1,0,0,0,1,1,3,a
crooks,3,0,0,0,2,0,5,a
passover seder,1,2,0,1,1,0,5,a
male,4,0,1,1,5,1,12,a
hello,2,0,14,0,1,3,20,a
weγçöre,4,7,2,0,0,0,13,a
thegoodgodabove,1,0,3,0,0,0,4,a
sean spicer's clarification,1,1,0,0,0,3,5,a
sean spicer slammed,2,2,0,0,0,0,4,a
bbg,0,0,0,1,0,2,3,a
trump's syria strike,2,2,0,0,0,2,6,a
shutting,1,0,0,0,1,1,3,a
secretary of state rex tillerson,5,0,0,0,0,0,5,a
gizmodo,1,0,2,0,0,1,4,a
doesnγçöt,1,3,0,0,0,1,5,a
marketwatch,0,0,2,1,0,0,3,a
question of the day,3,0,0,0,1,0,4,a
comparing assad,1,3,0,0,0,1,5,a
uber,3,0,5,0,2,2,12,a
bother,1,0,0,1,1,0,3,a
solves,4,0,0,0,3,1,8,a
youre,1,0,0,1,1,0,3,a
sees sean spicer,3,3,0,0,0,0,6,a
sean spicer justifies syria strike,4,0,0,0,0,0,4,a
communicator of the year,2,0,0,0,1,0,3,a
judging,1,0,1,0,1,0,3,a
white house easter bunny,5,3,0,0,0,0,8,a
calls nepotism,2,0,0,0,2,0,4,a
meanwhile,3,0,15,0,2,2,22,a
jews on holocaust remembrance day,4,0,0,0,0,0,4,a
trump aide,5,15,0,0,1,3,24,a
united flights,1,2,0,0,0,0,3,a
western,6,0,2,0,5,0,13,a
translation,1,0,5,0,1,3,10,a
give mediocre white men microphones,3,0,0,0,0,0,3,a
russia prior,1,2,0,0,0,0,3,a
mention hitler,0,3,0,2,0,0,5,a
ffs,0,0,1,15,3,14,33,a
syria strikes,2,7,0,0,0,2,11,a
hitler comments,6,24,0,0,0,13,43,a
iγçöve,1,1,2,0,0,0,4,a
memo,1,0,0,0,1,2,4,a
mike,4,0,1,0,2,5,12,a
sean spicerγçös firing,4,6,0,0,0,0,10,a
north korea threatens,1,1,0,0,0,1,3,a
update,1,0,1,4,2,2,10,a
ba,0,0,0,1,0,2,3,a
man sean spicer,3,2,0,0,1,1,7,a
ap,0,0,0,3,1,1,5,a
boom,6,0,2,7,4,19,38,a
sean spicer meant,4,5,0,0,0,1,10,a
sean spicer's mental health grows,3,0,0,0,0,0,3,a
sean spicer grovels,2,2,0,0,0,0,4,a
sam,2,0,0,0,2,0,4,a
clickhole,2,0,1,0,1,0,4,a
sean spicer's history,1,2,0,0,0,0,3,a
chase,1,0,0,0,1,1,3,a
sean spicer credits hitler,4,0,0,0,0,4,8,a
wh easter bunny,2,3,0,0,0,0,5,a
constitutional,2,0,0,0,2,0,4,a
stock market,2,1,0,0,2,0,5,a
ellemagazine,1,0,2,0,0,0,3,a
peanuts,1,0,0,0,1,1,3,a
tower,3,0,0,0,2,0,5,a
ca,0,0,0,4,1,1,6,a
stupid sean spicer,1,2,0,0,0,0,3,a
patience,2,0,0,0,2,0,4,a
satan,2,0,2,0,1,0,5,a
sean spicer show,2,3,0,0,0,0,5,a
spreading holocaust denial,2,2,0,0,0,3,7,a
polish death camps,0,0,0,1,0,2,3,a
spice,7,0,2,0,8,6,23,a
wmd,0,0,0,3,1,0,4,a
millions of americans,1,1,0,0,0,1,3,a
nazi gas,1,2,0,0,0,0,3,a
sean spicer causes uproar,5,1,0,0,0,3,9,a
ah,4,0,12,2,1,7,26,a
6m,0,0,0,2,1,0,3,a
kabuki,2,0,1,0,1,0,4,a
issa,1,0,2,0,0,0,3,a
tarred,1,0,0,0,0,6,7,a
nastiest,0,0,0,4,1,0,5,a
eric trump may,2,3,0,0,0,2,7,a
ru,0,0,0,4,1,0,5,a
bull shit,1,1,0,1,1,0,4,a
ignorant sean spicer,1,2,0,0,0,0,3,a
americas,3,0,0,0,2,0,5,a
robbing,0,0,0,1,0,2,3,a
candidate,cap,substring-cap,s-o-sCap,all-cap,non-cap,non-discriminative,cumulative,status
says trump,3,5,0,0,0,1,9,a
ask sean spicer,2,4,0,0,0,2,8,a
meals on wheels,2,2,0,0,1,0,5,a
republican,12,0,4,0,7,6,29,a
nazi death camps,3,5,0,0,0,0,8,a
senator,2,0,0,0,2,1,5,a
senators,2,0,0,0,2,1,5,a
ww1,0,0,0,4,1,0,5,a
devil,3,0,0,0,2,0,5,a
syria strike proves,11,9,0,0,0,6,26,a
clearance,1,0,0,0,1,2,4,a
record,2,0,0,0,2,0,4,a
apparently hitler,1,2,0,0,0,0,3,a
adminstration,2,0,0,0,2,0,4,a
allied,1,0,0,0,1,1,3,a
bingo,3,0,0,0,3,0,6,a
thereγçös,1,2,1,0,0,0,4,a
hitler comparison,4,8,0,0,0,3,15,a
attack on syria,2,2,0,0,0,0,4,a
syria strike,18,49,0,0,0,6,73,a
united ceo oscar munoz,3,0,0,1,0,1,5,a
trump told,1,3,0,0,0,0,4,a
god,56,0,13,2,60,49,180,a
easter egg,0,1,0,0,0,5,6,a
russia ties,11,29,0,0,1,7,48,a
sean spicer draws backlash,49,0,0,0,0,24,73,a
literally hitler,1,7,0,1,0,8,17,a
sob,1,0,0,2,2,1,6,a
press secretary sean spicer,48,11,0,0,0,9,68,a
measured,2,0,0,0,2,0,4,a
eric trump admits,4,4,0,0,0,2,10,a
bye bye,2,2,0,0,1,3,8,a
reaccomodated,2,0,0,0,2,0,4,a
pepsi ad,1,2,0,0,0,1,4,a
junior,3,0,2,0,2,1,8,a
cillizza,8,0,18,0,0,0,26,a
soldier,3,0,0,0,2,0,5,a
missile strike in syria,5,2,0,0,0,1,8,a
don the con,3,3,0,1,0,0,7,a
big win,1,0,0,0,1,3,5,a
daughter ivanka,2,3,0,0,0,4,9,a
pops,2,0,0,0,2,0,4,a
press secretary sean,1,2,0,0,0,0,3,a
your fired,1,0,0,0,1,1,3,a
sean spicer's false claim,2,0,0,0,0,1,3,a
woah,1,0,1,0,0,3,5,a
obstruction,1,0,2,0,1,2,6,a
jesus,11,0,17,0,1,23,52,a
civil rights,1,0,0,0,1,1,3,a
welp,2,0,3,0,0,7,12,a
jr,12,0,1,1,8,2,24,a
watching sean spicer,8,14,0,0,1,1,24,a
eff,1,0,0,0,1,1,3,a
asshats,1,0,0,0,1,1,3,a
martin,1,0,2,0,0,0,3,a
white people,1,0,0,0,1,1,3,a
sean spicer barca,3,0,0,0,0,7,10,a
eric trump proves,1,2,0,0,0,0,3,a
maga,0,0,0,7,3,2,12,a
defended hitler,1,3,0,0,0,12,16,a
god bless,2,3,0,0,0,1,6,a
swing,2,0,1,0,1,3,7,a
leftists,7,0,5,0,5,10,27,a
opposition,2,0,0,0,2,2,6,a
employment,2,0,0,0,2,1,5,a
jewish holiday,1,3,0,0,0,1,5,a
hitler comment,19,32,0,1,0,14,66,a
yesterday pepsi,1,3,0,0,0,0,4,a
billion,11,0,0,1,9,0,21,a
fire spicer,6,7,0,0,1,3,17,a
sean spicer apologizes,27,46,0,0,0,27,100,a
make america great again,3,2,0,1,0,0,6,a
progressives,2,0,1,0,2,0,5,a
ww3,0,0,0,19,8,0,27,a
defending hitler on passover,2,1,0,0,0,2,5,a
amen,1,0,0,1,2,5,9,a
drumpf,6,0,0,0,6,0,12,a
watched sean spicer,1,2,0,0,0,0,3,a
worldwide,1,0,0,1,1,1,4,a
corp,1,0,0,0,1,1,3,a
pants on fire,4,1,0,0,3,1,9,a
politifact,1,0,2,0,0,0,3,a
top 5,0,1,0,0,1,15,17,a
university,2,0,0,0,1,3,6,a
legal fisa,1,2,0,1,0,0,4,a
wh press secretary,5,8,0,0,0,1,14,a
goy,0,0,0,3,1,1,5,a
guess sean spicer,1,2,0,0,0,0,3,a
fbi fisa warrant,1,1,0,1,0,7,10,a
protecting,0,0,2,1,0,1,4,a
sister influenced presidentγçös decision,4,0,0,0,0,2,6,a
tfw,0,0,1,1,0,1,3,a
sale,1,0,0,0,1,2,4,a
pop,1,0,0,0,1,1,3,a
holocaust centre,6,4,0,0,4,3,17,a
holocaust gaffe,3,5,0,0,0,0,8,a
obama admin,1,3,0,0,0,1,5,a
impeach trump,1,2,0,0,0,1,4,a
jeff sessions lied,0,0,0,4,0,0,4,a
bullshit stunt,1,1,0,0,0,2,4,a
american government,1,2,0,0,0,0,3,a
flash,2,0,1,0,2,1,6,a
hitler remarks at press briefing,3,0,0,0,0,0,3,a
praises hitler,1,3,0,0,0,0,4,a
seder,10,0,0,0,9,1,20,a
feathered,1,0,0,0,0,6,7,a
sean spicer proves,2,2,0,0,0,0,4,a
say eric,1,2,0,0,0,0,3,a
tv,2,0,0,42,11,2,57,a
holo,1,0,0,0,1,1,3,a
objectivity,1,0,1,0,1,4,7,a
replace spicer,2,3,0,0,0,0,5,a
getting a fisa,1,2,0,0,0,0,3,a
receipts,0,0,0,2,1,0,3,a
russian spy,3,9,0,1,0,2,15,a
regarding sean spicer,1,2,0,0,0,0,3,a
scholar lawprof,1,0,0,0,0,6,7,a
heγçös,2,7,0,0,0,0,9,a
generals,6,0,0,0,4,2,12,a
carter page met,1,2,0,0,0,1,4,a
obviously sean spicer,2,2,0,0,0,0,4,a
tf,0,0,1,7,4,1,13,a
sean spicer falsely stated,1,0,0,0,0,2,3,a
white house press briefing,8,5,0,0,0,4,17,a
holocaust centers sean spicer,3,0,0,0,0,3,6,a
spent,4,0,1,0,4,0,9,a
disabled germans,1,2,0,0,0,0,3,a
fire trump,1,3,0,0,0,1,5,a
social studies,1,0,0,0,1,1,3,a
sean spicer went on cnn,3,0,0,0,0,0,3,a
jim,2,0,0,0,1,3,6,a
tucker,1,0,0,0,1,1,3,a
whoops,1,0,2,0,0,0,3,a
making america,2,3,0,0,0,0,5,a
sa,0,0,0,4,1,0,5,a
jews gassed,1,2,0,0,0,0,3,a
really sean spicer,1,1,0,0,0,3,5,a
meet in moscow on weekend,3,0,0,0,0,0,3,a
us government,1,2,0,0,0,0,3,a
safe zones,1,0,0,0,1,1,3,a
save sean spicer,2,2,0,0,0,2,6,a
bff,0,0,0,2,1,0,3,a
anne frank center calling,2,1,0,0,0,0,3,a
says ivanka,1,2,0,0,0,0,3,a
bannon in the white house,3,0,0,0,0,0,3,a
breaking,5,0,10,43,19,22,99,a
trumprussia,4,1,1,0,2,1,9,a
wag the dog,3,0,0,0,3,3,9,a
fo,0,0,0,2,1,0,3,a
stooges,2,0,0,0,2,0,4,a
court jester,3,0,0,0,3,0,6,a
gas jews,3,6,0,0,0,0,9,a
exclusive,2,0,3,0,1,0,6,a
matrix,1,0,0,0,1,1,3,a
barrel bomb,3,0,0,0,3,1,7,a
lefty,2,0,0,0,2,0,4,a
im,5,0,6,0,4,8,23,a
secretary of state tillerson,2,0,0,0,0,3,5,a
sean spicer video,2,2,0,0,0,0,4,a
holocaust remarks,3,8,0,0,1,1,13,a
trump news,1,0,0,0,1,1,3,a
knowγçö nazis used gas chambers,4,0,0,0,0,0,4,a
hitler gaffe causes uproar,2,0,0,0,0,2,4,a
fantastic,1,0,2,0,0,0,3,a
goonies,1,0,0,1,1,0,3,a
tfw alex jones,2,2,0,0,0,0,4,a
us eric trump,1,0,0,0,0,5,6,a
revealed,9,0,0,0,5,8,22,a
commander in chief,6,0,0,0,6,0,12,a
bears,1,0,0,0,1,1,3,a
middle class,1,0,0,0,1,1,3,a
reddit,1,0,0,0,1,1,3,a
pos,1,0,0,9,4,5,19,a
male number one,1,2,0,0,0,0,3,a
deplorables,1,0,0,0,1,1,3,a
bet sean spicer,2,2,0,0,0,0,4,a
argues assad gassing worse,1,0,0,0,0,2,3,a
stars,2,0,0,0,2,0,4,a
teamsters,1,0,2,0,0,0,3,a
hill,7,0,0,0,5,1,13,a
neil,1,0,0,0,0,4,5,a
tops,1,0,1,0,1,2,5,a
lieu,1,0,0,0,1,1,3,a
crooks,3,0,0,0,2,0,5,a
passover seder,1,2,0,1,1,0,5,a
weγçöre,4,7,2,0,0,0,13,a
thegoodgodabove,1,0,3,0,0,0,4,a
sean spicer's clarification,1,1,0,0,0,3,5,a
sean spicer slammed,2,2,0,0,0,0,4,a
bbg,0,0,0,1,0,2,3,a
trump's syria strike,2,2,0,0,0,2,6,a
liberal media,2,1,0,0,1,0,4,a
secretary of state rex tillerson,5,0,0,0,0,0,5,a
gizmodo,1,0,2,0,0,1,4,a
medical,1,0,0,0,1,1,3,a
doesnγçöt,1,3,0,0,0,1,5,a
marketwatch,0,0,2,1,0,0,3,a
question of the day,3,0,0,0,1,0,4,a
comparing assad,1,3,0,0,0,1,5,a
uber,3,0,5,0,2,2,12,a
bother,1,0,0,1,1,0,3,a
solves,4,0,0,0,3,1,8,a
youre,1,0,0,1,1,0,3,a
sees sean spicer,3,3,0,0,0,0,6,a
sean spicer justifies syria strike,4,0,0,0,0,0,4,a
communicator of the year,2,0,0,0,1,0,3,a
white house easter bunny,5,3,0,0,0,0,8,a
calls nepotism,2,0,0,0,2,0,4,a
jews on holocaust remembrance day,4,0,0,0,0,0,4,a
trump aide,5,15,0,0,1,3,24,a
united flights,1,2,0,0,0,0,3,a
western,6,0,2,0,5,0,13,a
give mediocre white men microphones,3,0,0,0,0,0,3,a
mike pence,2,1,0,0,1,0,4,a
russia prior,1,2,0,0,0,0,3,a
ffs,0,0,1,15,3,14,33,a
syria strikes,2,7,0,0,0,2,11,a
hitler comments,6,24,0,0,0,13,43,a
iγçöve,1,1,2,0,0,0,4,a
memo,1,0,0,0,1,2,4,a
mike,4,0,1,0,2,5,12,a
sean spicerγçös firing,4,6,0,0,0,0,10,a
north korea threatens,1,1,0,0,0,1,3,a
update,1,0,1,4,2,2,10,a
ba,0,0,0,1,0,2,3,a
man sean spicer,3,2,0,0,1,1,7,a
ap,0,0,0,3,1,1,5,a
boom,6,0,2,7,4,19,38,a
sean spicer meant,4,5,0,0,0,1,10,a
sean spicer's mental health grows,3,0,0,0,0,0,3,a
sean spicer grovels,2,2,0,0,0,0,4,a
sam,2,0,0,0,2,0,4,a
clickhole,2,0,1,0,1,0,4,a
pt,1,0,0,0,1,6,8,a
sean spicer's history,1,2,0,0,0,0,3,a
chase,1,0,0,0,1,1,3,a
sean spicer credits hitler,4,0,0,0,0,4,8,a
wh easter bunny,2,3,0,0,0,0,5,a
constitutional,2,0,0,0,2,0,4,a
stock market,2,1,0,0,2,0,5,a
ellemagazine,1,0,2,0,0,0,3,a
peanuts,1,0,0,0,1,1,3,a
tower,3,0,0,0,2,0,5,a
ca,0,0,0,4,1,1,6,a
stupid sean spicer,1,2,0,0,0,0,3,a
patience,2,0,0,0,2,0,4,a
satan,2,0,2,0,1,0,5,a
sean spicer show,2,3,0,0,0,0,5,a
spreading holocaust denial,2,2,0,0,0,3,7,a
polish death camps,0,0,0,1,0,2,3,a
spice,7,0,2,0,8,6,23,a
wmd,0,0,0,3,1,0,4,a
millions of americans,1,1,0,0,0,1,3,a
nazi gas,1,2,0,0,0,0,3,a
sean spicer causes uproar,5,1,0,0,0,3,9,a
ah,4,0,12,2,1,7,26,a
6m,0,0,0,2,1,0,3,a
kabuki,2,0,1,0,1,0,4,a
issa,1,0,2,0,0,0,3,a
tarred,1,0,0,0,0,6,7,a
nastiest,0,0,0,4,1,0,5,a
eric trump may,2,3,0,0,0,1,6,a
ru,0,0,0,4,1,0,5,a
bull shit,1,1,0,1,1,0,4,a
ignorant sean spicer,1,2,0,0,0,0,3,a
americas,3,0,0,0,2,0,5,a
robbing,0,0,0,1,0,2,3,a
candidate,cap,substring-cap,s-o-sCap,all-cap,non-cap,non-discriminative,cumulative,status
says trump,3,5,0,0,0,1,9,a
ask sean spicer,2,4,0,0,0,2,8,a
meals on wheels,2,2,0,0,1,0,5,a
republican,12,0,4,0,7,6,29,a
nazi death camps,3,5,0,0,0,0,8,a
senator,2,0,0,0,2,1,5,a
senators,2,0,0,0,2,1,5,a
ww1,0,0,0,4,1,0,5,a
devil,3,0,0,0,2,0,5,a
syria strike proves,11,9,0,0,0,6,26,a
clearance,1,0,0,0,1,2,4,a
record,2,0,0,0,2,0,4,a
white women,3,3,0,0,3,1,10,a
apparently hitler,1,2,0,0,0,0,3,a
adminstration,2,0,0,0,2,0,4,a
allied,1,0,0,0,1,1,3,a
bingo,3,0,0,0,3,0,6,a
thereγçös,1,2,1,0,0,0,4,a
hitler comparison,4,8,0,0,0,3,15,a
attack on syria,2,2,0,0,0,0,4,a
syria strike,18,49,0,0,0,6,73,a
united ceo oscar munoz,3,0,0,1,0,1,5,a
trump told,1,3,0,0,0,0,4,a
god,56,0,13,2,60,49,180,a
easter egg,0,1,0,0,0,5,6,a
whites,2,0,0,0,1,2,5,a
russia ties,11,29,0,0,1,7,48,a
sean spicer draws backlash,49,0,0,0,0,24,73,a
literally hitler,1,7,0,1,0,8,17,a
sob,1,0,0,2,2,1,6,a
press secretary sean spicer,48,11,0,0,0,9,68,a
measured,2,0,0,0,2,0,4,a
eric trump admits,4,4,0,0,0,2,10,a
bye bye,2,2,0,0,1,3,8,a
reaccomodated,2,0,0,0,2,0,4,a
pepsi ad,1,2,0,0,0,1,4,a
junior,3,0,2,0,2,1,8,a
cillizza,8,0,18,0,0,0,26,a
soldier,3,0,0,0,2,0,5,a
missile strike in syria,5,2,0,0,0,1,8,a
don the con,3,3,0,1,0,0,7,a
big win,1,0,0,0,1,3,5,a
daughter ivanka,2,3,0,0,0,4,9,a
pops,2,0,0,0,2,0,4,a
press secretary sean,1,2,0,0,0,0,3,a
your fired,1,0,0,0,1,1,3,a
sean spicer's false claim,2,0,0,0,0,1,3,a
woah,1,0,1,0,0,3,5,a
obstruction,1,0,2,0,1,2,6,a
jesus,11,0,17,0,1,23,52,a
civil rights,1,0,0,0,1,1,3,a
welp,2,0,3,0,0,7,12,a
jr,12,0,1,1,8,2,24,a
watching sean spicer,8,14,0,0,1,1,24,a
eff,1,0,0,0,1,1,3,a
asshats,1,0,0,0,1,1,3,a
martin,1,0,2,0,0,0,3,a
white people,1,0,0,0,1,1,3,a
sean spicer barca,3,0,0,0,0,7,10,a
eric trump proves,1,2,0,0,0,0,3,a
maga,0,0,0,7,3,2,12,a
defended hitler,1,3,0,0,0,12,16,a
god bless,2,3,0,0,0,1,6,a
swing,2,0,1,0,1,3,7,a
leftists,7,0,5,0,5,10,27,a
opposition,2,0,0,0,2,2,6,a
employment,2,0,0,0,2,1,5,a
jewish holiday,1,3,0,0,0,1,5,a
hitler comment,19,32,0,1,0,14,66,a
yesterday pepsi,1,3,0,0,0,0,4,a
billion,11,0,0,1,9,0,21,a
fire spicer,6,7,0,0,1,3,17,a
sean spicer apologizes,27,46,0,0,0,27,100,a
make america great again,3,2,0,1,0,0,6,a
progressives,2,0,1,0,2,0,5,a
ww3,0,0,0,19,8,0,27,a
defending hitler on passover,2,1,0,0,0,2,5,a
amen,1,0,0,1,2,5,9,a
drumpf,6,0,0,0,6,0,12,a
watched sean spicer,1,2,0,0,0,0,3,a
worldwide,1,0,0,1,1,1,4,a
corp,1,0,0,0,1,1,3,a
pants on fire,4,1,0,0,3,1,9,a
politifact,1,0,2,0,0,0,3,a
top 5,0,1,0,0,1,15,17,a
university,2,0,0,0,1,3,6,a
legal fisa,1,2,0,1,0,0,4,a
wh press secretary,5,8,0,0,0,1,14,a
goy,0,0,0,3,1,1,5,a
guess sean spicer,1,2,0,0,0,0,3,a
fbi fisa warrant,1,1,0,1,0,7,10,a
protecting,0,0,2,1,0,1,4,a
sister influenced presidentγçös decision,4,0,0,0,0,2,6,a
tfw,0,0,1,1,0,1,3,a
sale,1,0,0,0,1,2,4,a
pop,1,0,0,0,1,1,3,a
holocaust centre,6,4,0,0,4,3,17,a
holocaust gaffe,3,5,0,0,0,0,8,a
obama admin,1,3,0,0,0,1,5,a
impeach trump,1,2,0,0,0,1,4,a
jeff sessions lied,0,0,0,4,0,0,4,a
bullshit stunt,1,1,0,0,0,2,4,a
american government,1,2,0,0,0,0,3,a
flash,2,0,1,0,2,1,6,a
hitler remarks at press briefing,3,0,0,0,0,0,3,a
praises hitler,1,3,0,0,0,0,4,a
seder,10,0,0,0,9,1,20,a
feathered,1,0,0,0,0,6,7,a
sean spicer proves,2,2,0,0,0,0,4,a
say eric,1,2,0,0,0,0,3,a
tv,2,0,0,42,11,2,57,a
holo,1,0,0,0,1,1,3,a
objectivity,1,0,1,0,1,4,7,a
replace spicer,2,3,0,0,0,0,5,a
getting a fisa,1,2,0,0,0,0,3,a
receipts,0,0,0,2,1,0,3,a
russian spy,3,9,0,1,0,2,15,a
regarding sean spicer,1,2,0,0,0,0,3,a
scholar lawprof,1,0,0,0,0,6,7,a
heγçös,2,7,0,0,0,0,9,a
generals,6,0,0,0,4,2,12,a
carter page met,1,2,0,0,0,1,4,a
obviously sean spicer,2,2,0,0,0,0,4,a
tf,0,0,1,7,4,1,13,a
sean spicer falsely stated,1,0,0,0,0,2,3,a
white house press briefing,8,5,0,0,0,4,17,a
holocaust centers sean spicer,3,0,0,0,0,3,6,a
spent,4,0,1,0,4,0,9,a
disabled germans,1,2,0,0,0,0,3,a
fire trump,1,3,0,0,0,1,5,a
social studies,1,0,0,0,1,1,3,a
sean spicer went on cnn,3,0,0,0,0,0,3,a
jim,2,0,0,0,1,3,6,a
tucker,1,0,0,0,1,1,3,a
whoops,1,0,2,0,0,0,3,a
making america,2,3,0,0,0,0,5,a
sa,0,0,0,4,1,0,5,a
jews gassed,1,2,0,0,0,0,3,a
really sean spicer,1,1,0,0,0,3,5,a
meet in moscow on weekend,3,0,0,0,0,0,3,a
us government,1,2,0,0,0,0,3,a
safe zones,1,0,0,0,1,1,3,a
save sean spicer,2,2,0,0,0,2,6,a
bff,0,0,0,2,1,0,3,a
anne frank center calling,2,1,0,0,0,0,3,a
says ivanka,1,2,0,0,0,0,3,a
bannon in the white house,3,0,0,0,0,0,3,a
breaking,5,0,10,43,19,22,99,a
trumprussia,4,1,1,0,2,1,9,a
wag the dog,3,0,0,0,3,3,9,a
fo,0,0,0,2,1,0,3,a
stooges,2,0,0,0,2,0,4,a
court jester,3,0,0,0,3,0,6,a
gas jews,3,6,0,0,0,0,9,a
exclusive,2,0,3,0,1,0,6,a
matrix,1,0,0,0,1,1,3,a
barrel bomb,3,0,0,0,3,1,7,a
lefty,2,0,0,0,2,0,4,a
im,5,0,6,0,4,8,23,a
secretary of state tillerson,2,0,0,0,0,3,5,a
sean spicer video,2,2,0,0,0,0,4,a
holocaust remarks,3,8,0,0,1,1,13,a
trump news,1,0,0,0,1,1,3,a
knowγçö nazis used gas chambers,4,0,0,0,0,0,4,a
hitler gaffe causes uproar,2,0,0,0,0,2,4,a
fantastic,1,0,2,0,0,0,3,a
goonies,1,0,0,1,1,0,3,a
tfw alex jones,2,2,0,0,0,0,4,a
us eric trump,1,0,0,0,0,5,6,a
revealed,9,0,0,0,5,8,22,a
commander in chief,6,0,0,0,6,0,12,a
bears,1,0,0,0,1,1,3,a
middle class,1,0,0,0,1,1,3,a
reddit,1,0,0,0,1,1,3,a
pos,1,0,0,9,4,5,19,a
male number one,1,2,0,0,0,0,3,a
deplorables,1,0,0,0,1,1,3,a
bet sean spicer,2,2,0,0,0,0,4,a
argues assad gassing worse,1,0,0,0,0,2,3,a
stars,2,0,0,0,2,0,4,a
teamsters,1,0,2,0,0,0,3,a
hill,7,0,0,0,5,1,13,a
neil,1,0,0,0,0,4,5,a
tops,1,0,1,0,1,2,5,a
lieu,1,0,0,0,1,1,3,a
crooks,3,0,0,0,2,0,5,a
passover seder,1,2,0,1,1,0,5,a
weγçöre,4,7,2,0,0,0,13,a
thegoodgodabove,1,0,3,0,0,0,4,a
sean spicer's clarification,1,1,0,0,0,3,5,a
sean spicer slammed,2,2,0,0,0,0,4,a
bbg,0,0,0,1,0,2,3,a
trump's syria strike,2,2,0,0,0,2,6,a
liberal media,2,1,0,0,1,0,4,a
secretary of state rex tillerson,5,0,0,0,0,0,5,a
gizmodo,1,0,2,0,0,1,4,a
medical,1,0,0,0,1,1,3,a
doesnγçöt,1,3,0,0,0,1,5,a
marketwatch,0,0,2,1,0,0,3,a
question of the day,3,0,0,0,1,0,4,a
comparing assad,1,3,0,0,0,1,5,a
uber,3,0,5,0,2,2,12,a
bother,1,0,0,1,1,0,3,a
solves,4,0,0,0,3,1,8,a
youre,1,0,0,1,1,0,3,a
sees sean spicer,3,3,0,0,0,0,6,a
sean spicer justifies syria strike,4,0,0,0,0,0,4,a
communicator of the year,2,0,0,0,1,0,3,a
white house easter bunny,5,3,0,0,0,0,8,a
calls nepotism,2,0,0,0,2,0,4,a
jews on holocaust remembrance day,4,0,0,0,0,0,4,a
trump aide,5,15,0,0,1,3,24,a
united flights,1,2,0,0,0,0,3,a
western,6,0,2,0,5,0,13,a
give mediocre white men microphones,3,0,0,0,0,0,3,a
mike pence,2,1,0,0,1,0,4,a
russia prior,1,2,0,0,0,0,3,a
mention hitler,0,3,0,2,0,0,5,a
ffs,0,0,1,15,3,14,33,a
syria strikes,2,7,0,0,0,2,11,a
hitler comments,6,24,0,0,0,13,43,a
iγçöve,1,1,2,0,0,0,4,a
memo,1,0,0,0,1,2,4,a
mike,4,0,1,0,2,5,12,a
sean spicerγçös firing,4,6,0,0,0,0,10,a
north korea threatens,1,1,0,0,0,1,3,a
update,1,0,1,4,2,2,10,a
ba,0,0,0,1,0,2,3,a
man sean spicer,3,2,0,0,1,1,7,a
ap,0,0,0,3,1,1,5,a
boom,6,0,2,7,4,19,38,a
sean spicer meant,4,5,0,0,0,1,10,a
sean spicer's mental health grows,3,0,0,0,0,0,3,a
sean spicer grovels,2,2,0,0,0,0,4,a
sam,2,0,0,0,2,0,4,a
clickhole,2,0,1,0,1,0,4,a
pt,1,0,0,0,1,6,8,a
sean spicer's history,1,2,0,0,0,0,3,a
chase,1,0,0,0,1,1,3,a
sean spicer credits hitler,4,0,0,0,0,4,8,a
wh easter bunny,2,3,0,0,0,0,5,a
constitutional,2,0,0,0,2,0,4,a
stock market,2,1,0,0,2,0,5,a
ellemagazine,1,0,2,0,0,0,3,a
gifs,2,0,0,0,1,2,5,a
peanuts,1,0,0,0,1,1,3,a
tower,3,0,0,0,2,0,5,a
ca,0,0,0,4,1,1,6,a
stupid sean spicer,1,2,0,0,0,0,3,a
patience,2,0,0,0,2,0,4,a
satan,2,0,2,0,1,0,5,a
sean spicer show,2,3,0,0,0,0,5,a
spreading holocaust denial,2,2,0,0,0,3,7,a
polish death camps,0,0,0,1,0,2,3,a
spice,7,0,2,0,8,6,23,a
wmd,0,0,0,3,1,0,4,a
millions of americans,1,1,0,0,0,1,3,a
nazi gas,1,2,0,0,0,0,3,a
sean spicer causes uproar,5,1,0,0,0,3,9,a
ah,4,0,12,2,1,7,26,a
6m,0,0,0,2,1,0,3,a
kabuki,2,0,1,0,1,0,4,a
issa,1,0,2,0,0,0,3,a
tarred,1,0,0,0,0,6,7,a
nastiest,0,0,0,4,1,0,5,a
eric trump may,2,3,0,0,0,1,6,a
ru,0,0,0,4,1,0,5,a
bull shit,1,1,0,1,1,0,4,a
ignorant sean spicer,1,2,0,0,0,0,3,a
americas,3,0,0,0,2,0,5,a
robbing,0,0,0,1,0,2,3,a
candidate,cap,substring-cap,s-o-sCap,all-cap,non-cap,non-discriminative,cumulative,status
says trump,3,5,0,0,0,1,9,a
meals on wheels,2,2,0,0,1,0,5,a
republican,12,0,4,0,7,6,29,a
nazi death camps,3,5,0,0,0,0,8,a
senator,2,0,0,0,2,1,5,a
senators,2,0,0,0,2,1,5,a
ww1,0,0,0,4,1,0,5,a
devil,3,0,0,0,2,0,5,a
syria strike proves,11,9,0,0,0,6,26,a
clearance,1,0,0,0,1,2,4,a
record,2,0,0,0,2,0,4,a
apparently hitler,1,2,0,0,0,0,3,a
adminstration,2,0,0,0,2,0,4,a
allied,1,0,0,0,1,1,3,a
bingo,3,0,0,0,3,0,6,a
thereγçös,1,2,1,0,0,0,4,a
hitler comparison,4,8,0,0,0,3,15,a
attack on syria,2,2,0,0,0,0,4,a
syria strike,18,49,0,0,0,6,73,a
united ceo oscar munoz,3,0,0,1,0,1,5,a
trump told,1,3,0,0,0,0,4,a
god,56,0,13,2,60,49,180,a
easter egg,0,1,0,0,0,5,6,a
whites,2,0,0,0,1,2,5,a
russia ties,11,29,0,0,1,7,48,a
sean spicer draws backlash,49,0,0,0,0,24,73,a
literally hitler,1,7,0,1,0,8,17,a
sob,1,0,0,2,2,1,6,a
press secretary sean spicer,48,11,0,0,0,9,68,a
measured,2,0,0,0,2,0,4,a
eric trump admits,4,4,0,0,0,2,10,a
bye bye,2,2,0,0,1,3,8,a
reaccomodated,2,0,0,0,2,0,4,a
pepsi ad,1,2,0,0,0,1,4,a
junior,3,0,2,0,2,1,8,a
cillizza,8,0,18,0,0,0,26,a
soldier,3,0,0,0,2,0,5,a
missile strike in syria,5,2,0,0,0,1,8,a
don the con,3,3,0,1,0,0,7,a
big win,1,0,0,0,1,3,5,a
daughter ivanka,2,3,0,0,0,4,9,a
pops,2,0,0,0,2,0,4,a
press secretary sean,1,2,0,0,0,0,3,a
your fired,1,0,0,0,1,1,3,a
sean spicer's false claim,2,0,0,0,0,1,3,a
woah,1,0,1,0,0,3,5,a
obstruction,1,0,2,0,1,2,6,a
jesus,11,0,17,0,1,23,52,a
civil rights,1,0,0,0,1,1,3,a
welp,2,0,3,0,0,7,12,a
jr,12,0,1,1,8,2,24,a
watching sean spicer,8,14,0,0,1,1,24,a
eff,1,0,0,0,1,1,3,a
asshats,1,0,0,0,1,1,3,a
martin,1,0,2,0,0,0,3,a
white people,1,0,0,0,1,1,3,a
sean spicer barca,3,0,0,0,0,7,10,a
eric trump proves,1,2,0,0,0,0,3,a
maga,0,0,0,7,3,2,12,a
defended hitler,1,3,0,0,0,12,16,a
god bless,2,3,0,0,0,1,6,a
swing,2,0,1,0,1,3,7,a
leftists,7,0,5,0,5,10,27,a
opposition,2,0,0,0,2,2,6,a
employment,2,0,0,0,2,1,5,a
jewish holiday,1,3,0,0,0,1,5,a
hitler comment,19,32,0,1,0,14,66,a
yesterday pepsi,1,3,0,0,0,0,4,a
billion,11,0,0,1,9,0,21,a
fire spicer,6,7,0,0,1,3,17,a
sean spicer apologizes,27,46,0,0,0,27,100,a
make america great again,3,2,0,1,0,0,6,a
progressives,2,0,1,0,2,0,5,a
ww3,0,0,0,19,8,0,27,a
defending hitler on passover,2,1,0,0,0,2,5,a
amen,1,0,0,1,2,5,9,a
drumpf,6,0,0,0,6,0,12,a
watched sean spicer,1,2,0,0,0,0,3,a
worldwide,1,0,0,1,1,1,4,a
corp,1,0,0,0,1,1,3,a
pants on fire,4,1,0,0,3,1,9,a
politifact,1,0,2,0,0,0,3,a
top 5,0,1,0,0,1,15,17,a
university,2,0,0,0,1,3,6,a
legal fisa,1,2,0,1,0,0,4,a
wh press secretary,5,9,0,0,0,1,15,a
goy,0,0,0,3,1,1,5,a
guess sean spicer,1,2,0,0,0,0,3,a
fbi fisa warrant,1,1,0,1,0,7,10,a
protecting,0,0,2,1,0,1,4,a
sister influenced presidentγçös decision,4,0,0,0,0,2,6,a
tfw,0,0,1,1,0,1,3,a
sale,1,0,0,0,1,2,4,a
pop,1,0,0,0,1,1,3,a
holocaust centre,6,4,0,0,4,3,17,a
holocaust gaffe,3,5,0,0,0,0,8,a
obama admin,1,3,0,0,0,1,5,a
impeach trump,1,2,0,0,0,1,4,a
jeff sessions lied,0,0,0,4,0,0,4,a
bullshit stunt,1,1,0,0,0,2,4,a
american government,1,2,0,0,0,0,3,a
potato,2,0,0,0,2,0,4,a
flash,2,0,1,0,2,1,6,a
hitler remarks at press briefing,3,0,0,0,0,0,3,a
praises hitler,1,3,0,0,0,0,4,a
seder,10,0,0,0,9,1,20,a
feathered,1,0,0,0,0,6,7,a
sean spicer proves,2,2,0,0,0,0,4,a
say eric,1,2,0,0,0,0,3,a
tv,2,0,0,42,11,2,57,a
holo,1,0,0,0,1,1,3,a
objectivity,1,0,1,0,1,4,7,a
replace spicer,2,3,0,0,0,0,5,a
getting a fisa,1,2,0,0,0,0,3,a
receipts,0,0,0,2,1,0,3,a
russian spy,3,9,0,1,0,2,15,a
regarding sean spicer,1,2,0,0,0,0,3,a
scholar lawprof,1,0,0,0,0,6,7,a
heγçös,2,7,0,0,0,0,9,a
generals,6,0,0,0,4,2,12,a
carter page met,1,2,0,0,0,1,4,a
obviously sean spicer,2,2,0,0,0,0,4,a
tf,0,0,1,7,4,1,13,a
sean spicer falsely stated,1,0,0,0,0,2,3,a
white house press briefing,8,5,0,0,0,4,17,a
holocaust centers sean spicer,3,0,0,0,0,3,6,a
spent,4,0,1,0,4,0,9,a
disabled germans,1,2,0,0,0,0,3,a
fire trump,1,3,0,0,0,1,5,a
social studies,1,0,0,0,1,1,3,a
sean spicer went on cnn,3,0,0,0,0,0,3,a
jim,2,0,0,0,1,3,6,a
tucker,1,0,0,0,1,1,3,a
whoops,1,0,2,0,0,0,3,a
making america,2,3,0,0,0,0,5,a
sa,0,0,0,4,1,0,5,a
jews gassed,1,2,0,0,0,0,3,a
really sean spicer,1,1,0,0,0,3,5,a
meet in moscow on weekend,3,0,0,0,0,0,3,a
us government,1,2,0,0,0,0,3,a
safe zones,1,0,0,0,1,1,3,a
save sean spicer,2,2,0,0,0,2,6,a
bff,0,0,0,2,1,0,3,a
anne frank center calling,2,1,0,0,0,0,3,a
says ivanka,1,2,0,0,0,0,3,a
bannon in the white house,3,0,0,0,0,0,3,a
breaking,5,0,10,43,19,22,99,a
trumprussia,4,1,1,0,2,1,9,a
wag the dog,3,0,0,0,3,3,9,a
fo,0,0,0,2,1,0,3,a
stooges,2,0,0,0,2,0,4,a
court jester,3,0,0,0,3,0,6,a
gas jews,3,6,0,0,0,0,9,a
exclusive,2,0,3,0,1,0,6,a
matrix,1,0,0,0,1,1,3,a
barrel bomb,3,0,0,0,3,1,7,a
lefty,2,0,0,0,2,0,4,a
im,5,0,6,0,4,8,23,a
secretary of state tillerson,2,0,0,0,0,3,5,a
sean spicer video,2,2,0,0,0,0,4,a
holocaust remarks,3,8,0,0,1,1,13,a
sheesh,1,0,1,0,0,2,4,a
trump news,1,0,0,0,1,1,3,a
knowγçö nazis used gas chambers,4,0,0,0,0,0,4,a
hitler gaffe causes uproar,2,0,0,0,0,2,4,a
fantastic,1,0,2,0,0,0,3,a
goonies,1,0,0,1,1,0,3,a
tfw alex jones,2,2,0,0,0,0,4,a
us eric trump,1,0,0,0,0,5,6,a
revealed,9,0,0,0,5,8,22,a
commander in chief,6,0,0,0,6,0,12,a
bears,1,0,0,0,1,1,3,a
middle class,1,0,0,0,1,1,3,a
reddit,1,0,0,0,1,1,3,a
pos,1,0,0,9,4,5,19,a
male number one,1,2,0,0,0,0,3,a
deplorables,1,0,0,0,1,1,3,a
bet sean spicer,2,2,0,0,0,0,4,a
argues assad gassing worse,1,0,0,0,0,2,3,a
stars,2,0,0,0,2,0,4,a
teamsters,1,0,2,0,0,0,3,a
hill,7,0,0,0,5,1,13,a
neil,1,0,0,0,0,4,5,a
tops,1,0,1,0,1,2,5,a
lieu,1,0,0,0,1,1,3,a
crooks,3,0,0,0,2,0,5,a
passover seder,1,2,0,1,1,0,5,a
weγçöre,4,7,2,0,0,0,13,a
thegoodgodabove,1,0,3,0,0,0,4,a
sean spicer's clarification,1,1,0,0,0,3,5,a
sean spicer slammed,2,2,0,0,0,0,4,a
bbg,0,0,0,1,0,2,3,a
trump's syria strike,2,2,0,0,0,2,6,a
liberal media,2,1,0,0,1,0,4,a
secretary of state rex tillerson,5,0,0,0,0,0,5,a
gizmodo,1,0,2,0,0,1,4,a
medical,1,0,0,0,1,1,3,a
doesnγçöt,1,3,0,0,0,1,5,a
marketwatch,0,0,2,1,0,0,3,a
question of the day,3,0,0,0,1,0,4,a
comparing assad,1,3,0,0,0,1,5,a
uber,3,0,5,0,2,2,12,a
bother,1,0,0,1,1,0,3,a
solves,4,0,0,0,3,1,8,a
youre,1,0,0,1,1,0,3,a
sees sean spicer,3,3,0,0,0,0,6,a
sean spicer justifies syria strike,4,0,0,0,0,0,4,a
communicator of the year,2,0,0,0,1,0,3,a
white house easter bunny,5,3,0,0,0,0,8,a
calls nepotism,2,0,0,0,2,0,4,a
jews on holocaust remembrance day,4,0,0,0,0,0,4,a
trump aide,5,15,0,0,1,3,24,a
united flights,1,2,0,0,0,0,3,a
western,6,0,2,0,5,0,13,a
mall,2,0,0,0,2,0,4,a
give mediocre white men microphones,3,0,0,0,0,0,3,a
mike pence,2,1,0,0,1,0,4,a
russia prior,1,2,0,0,0,0,3,a
ffs,0,0,1,15,3,14,33,a
syria strikes,2,7,0,0,0,2,11,a
iγçöve,1,1,2,0,0,0,4,a
memo,1,0,0,0,1,2,4,a
mike,4,0,1,0,2,5,12,a
sean spicerγçös firing,4,6,0,0,0,0,10,a
north korea threatens,1,1,0,0,0,1,3,a
update,1,0,1,4,2,2,10,a
ba,0,0,0,1,0,2,3,a
man sean spicer,3,2,0,0,1,1,7,a
ap,0,0,0,3,1,1,5,a
boom,6,0,2,7,4,19,38,a
sean spicer meant,4,5,0,0,0,1,10,a
sean spicer's mental health grows,3,0,0,0,0,0,3,a
sean spicer grovels,2,2,0,0,0,0,4,a
sam,2,0,0,0,2,0,4,a
clickhole,2,0,1,0,1,0,4,a
pt,1,0,0,0,1,6,8,a
sean spicer's history,1,2,0,0,0,0,3,a
chase,1,0,0,0,1,1,3,a
sean spicer credits hitler,4,0,0,0,0,4,8,a
wh easter bunny,2,3,0,0,0,0,5,a
constitutional,2,0,0,0,2,0,4,a
stock market,2,1,0,0,2,0,5,a
ellemagazine,1,0,2,0,0,0,3,a
gifs,2,0,0,0,1,2,5,a
peanuts,1,0,0,0,1,1,3,a
tower,3,0,0,0,2,0,5,a
ca,0,0,0,4,1,1,6,a
patience,2,0,0,0,2,0,4,a
satan,2,0,2,0,1,0,5,a
sean spicer show,2,3,0,0,0,1,6,a
spreading holocaust denial,2,2,0,0,0,3,7,a
polish death camps,0,0,0,1,0,2,3,a
spice,7,0,2,0,8,6,23,a
wmd,0,0,0,3,1,0,4,a
millions of americans,1,1,0,0,0,1,3,a
induced,1,0,0,0,1,1,3,a
nazi gas,1,2,0,0,0,0,3,a
sean spicer causes uproar,5,1,0,0,0,3,9,a
tiny,1,0,0,0,0,4,5,a
ah,4,0,12,2,1,7,26,a
6m,0,0,0,2,1,0,3,a
kabuki,2,0,1,0,1,0,4,a
issa,1,0,2,0,0,0,3,a
tarred,1,0,0,0,0,6,7,a
nastiest,0,0,0,4,1,0,5,a
eric trump may,2,3,0,0,0,1,6,a
ru,0,0,0,4,1,0,5,a
bull shit,1,1,0,1,1,0,4,a
holocaust center,64,40,0,1,25,20,150,a
ignorant sean spicer,1,2,0,0,0,0,3,a
americas,3,0,0,0,2,0,5,a
robbing,0,0,0,1,0,2,3,a
candidate,cap,substring-cap,s-o-sCap,all-cap,non-cap,non-discriminative,cumulative,status
says trump,3,5,0,0,0,1,9,a
meals on wheels,2,2,0,0,1,0,5,a
republican,12,0,4,0,7,6,29,a
nazi death camps,3,5,0,0,0,0,8,a
senator,2,0,0,0,2,1,5,a
senators,2,0,0,0,2,1,5,a
ww1,0,0,0,4,1,0,5,a
devil,3,0,0,0,2,0,5,a
syria strike proves,11,9,0,0,0,6,26,a
clearance,1,0,0,0,1,2,4,a
record,2,0,0,0,2,0,4,a
white women,3,3,0,0,3,1,10,a
apparently hitler,1,2,0,0,0,0,3,a
adminstration,2,0,0,0,2,0,4,a
allied,1,0,0,0,1,1,3,a
bingo,3,0,0,0,3,0,6,a
thereγçös,1,2,1,0,0,0,4,a
hitler comparison,4,9,0,0,0,3,16,a
attack on syria,2,2,0,0,0,0,4,a
syria strike,18,49,0,0,0,6,73,a
united ceo oscar munoz,3,0,0,1,0,1,5,a
trump told,1,3,0,0,0,0,4,a
god,56,0,13,2,60,49,180,a
easter egg,0,1,0,0,0,5,6,a
whites,2,0,0,0,1,2,5,a
russia ties,11,29,0,0,1,7,48,a
sean spicer draws backlash,49,0,0,0,0,24,73,a
literally hitler,1,7,0,1,0,8,17,a
sob,1,0,0,2,2,1,6,a
press secretary sean spicer,48,11,0,0,0,9,68,a
hope ivanka,1,1,0,0,1,0,3,a
us secretary of state,5,5,0,0,0,0,10,a
measured,2,0,0,0,2,0,4,a
eric trump admits,4,4,0,0,0,2,10,a
bye bye,2,2,0,0,1,3,8,a
pr stunt,1,4,0,0,0,1,6,a
reaccomodated,2,0,0,0,2,0,4,a
pepsi ad,1,2,0,0,0,1,4,a
junior,3,0,2,0,2,1,8,a
cillizza,8,0,18,0,0,0,26,a
us history,1,4,0,0,0,1,6,a
soldier,3,0,0,0,2,0,5,a
missile strike in syria,5,2,0,0,0,1,8,a
don the con,3,3,0,1,0,0,7,a
big win,1,0,0,0,1,3,5,a
daughter ivanka,2,3,0,0,0,4,9,a
pops,2,0,0,0,2,0,4,a
press secretary sean,1,2,0,0,0,0,3,a
your fired,1,0,0,0,1,1,3,a
sean spicer's false claim,2,0,0,0,0,1,3,a
woah,1,0,1,0,0,3,5,a
obstruction,1,0,2,0,1,2,6,a
jesus,11,0,17,0,1,23,52,a
civil rights,1,0,0,0,1,1,3,a
welp,2,0,3,0,0,7,12,a
jr,12,0,1,1,8,2,24,a
watching sean spicer,8,14,0,0,1,1,24,a
eff,1,0,0,0,1,1,3,a
asshats,1,0,0,0,1,1,3,a
martin,1,0,2,0,0,0,3,a
white people,1,0,0,0,1,1,3,a
sean spicer barca,3,0,0,0,0,7,10,a
eric trump proves,1,2,0,0,0,0,3,a
maga,0,0,0,7,3,2,12,a
defended hitler,1,3,0,0,0,12,16,a
god bless,2,3,0,0,0,1,6,a
swing,2,0,1,0,1,3,7,a
leftists,7,0,5,0,5,10,27,a
opposition,2,0,0,0,2,2,6,a
employment,2,0,0,0,2,1,5,a
jewish holiday,1,3,0,0,0,1,5,a
hitler comment,19,32,0,1,0,14,66,a
yesterday pepsi,1,3,0,0,0,0,4,a
google,9,0,4,1,11,5,30,a
sean spicer holocaust centers,8,1,0,0,0,25,34,a
trump administration,33,99,0,1,10,7,150,a
billion,11,0,0,1,9,0,21,a
fire spicer,6,7,0,0,1,3,17,a
sean spicer's holocaust comments,2,2,0,0,0,0,4,a
sean spicer apologizes,27,46,0,0,0,27,100,a
make america great again,3,2,0,1,0,0,6,a
progressives,2,0,1,0,2,0,5,a
ww3,0,0,0,19,8,0,27,a
defending hitler on passover,2,1,0,0,0,2,5,a
amen,1,0,0,1,2,5,9,a
drumpf,6,0,0,0,6,0,12,a
watched sean spicer,1,2,0,0,0,0,3,a
corp,1,0,0,0,1,1,3,a
pants on fire,4,1,0,0,3,1,9,a
politifact,1,0,2,0,0,0,3,a
top 5,0,1,0,0,1,15,17,a
university,2,0,0,0,1,3,6,a
legal fisa,1,2,0,1,0,0,4,a
wh press secretary,5,9,0,0,0,1,15,a
goy,0,0,0,3,1,1,5,a
guess sean spicer,1,2,0,0,0,0,3,a
fbi fisa warrant,1,1,0,1,0,7,10,a
protecting,0,0,2,1,0,1,4,a
sister influenced presidentγçös decision,4,0,0,0,0,2,6,a
tfw,0,0,1,1,0,1,3,a
sale,1,0,0,0,1,2,4,a
pop,1,0,0,0,1,1,3,a
holocaust centre,6,4,0,0,4,3,17,a
holocaust gaffe,3,5,0,0,0,0,8,a
obama admin,1,3,0,0,0,1,5,a
impeach trump,1,2,0,0,0,1,4,a
jeff sessions lied,0,0,0,4,0,0,4,a
bullshit stunt,1,1,0,0,0,2,4,a
american government,1,2,0,0,0,0,3,a
potato,2,0,0,0,2,0,4,a
flash,2,0,1,0,2,1,6,a
hitler remarks at press briefing,3,0,0,0,0,0,3,a
praises hitler,1,3,0,0,0,0,4,a
seder,10,0,0,0,9,1,20,a
feathered,1,0,0,0,0,6,7,a
sean spicer proves,2,2,0,0,0,0,4,a
say eric,1,2,0,0,0,0,3,a
tv,2,0,0,42,11,2,57,a
blonde,1,0,1,0,1,0,3,a
wikipedia,1,0,1,0,1,0,3,a
trump train,2,2,0,0,2,0,6,a
holocaust remembrance,1,1,0,0,1,0,3,a
holo,1,0,0,0,1,1,3,a
objectivity,1,0,1,0,1,4,7,a
replace spicer,2,3,0,0,0,0,5,a
getting a fisa,1,2,0,0,0,0,3,a
receipts,0,0,0,2,1,0,3,a
russian spy,3,9,0,1,0,2,15,a
regarding sean spicer,1,2,0,0,0,0,3,a
scholar lawprof,1,0,0,0,0,6,7,a
heγçös,2,7,0,0,0,0,9,a
generals,6,0,0,0,4,2,12,a
carter page met,1,2,0,0,0,1,4,a
obviously sean spicer,2,2,0,0,0,0,4,a
tf,0,0,1,7,4,1,13,a
sean spicer falsely stated,1,0,0,0,0,2,3,a
white house press briefing,8,5,0,0,0,4,17,a
holocaust centers sean spicer,3,0,0,0,0,3,6,a
subtlety,1,0,1,0,1,0,3,a
spent,4,0,1,0,4,0,9,a
disabled germans,1,2,0,0,0,0,3,a
fire trump,1,3,0,0,0,1,5,a
yelp,1,0,1,0,1,0,3,a
social studies,1,0,0,0,1,1,3,a
sean spicer went on cnn,3,0,0,0,0,0,3,a
jim,2,0,0,0,1,3,6,a
tucker,1,0,0,0,1,1,3,a
whoops,1,0,2,0,0,0,3,a
making america,2,3,0,0,0,0,5,a
sa,0,0,0,4,1,0,5,a
far right,1,1,0,0,1,0,3,a
jews gassed,1,2,0,0,0,0,3,a
really sean spicer,1,1,0,0,0,3,5,a
meet in moscow on weekend,3,0,0,0,0,0,3,a
us government,1,2,0,0,0,0,3,a
safe zones,1,0,0,0,1,1,3,a
save sean spicer,2,2,0,0,0,2,6,a
bff,0,0,0,2,1,0,3,a
anne frank center calling,2,1,0,0,0,0,3,a
says ivanka,1,2,0,0,0,0,3,a
bannon in the white house,3,0,0,0,0,0,3,a
breaking,5,0,10,43,19,22,99,a
trumprussia,4,1,1,0,2,1,9,a
wag the dog,3,0,0,0,3,3,9,a
fo,0,0,0,2,1,0,3,a
stooges,2,0,0,0,2,0,4,a
court jester,3,0,0,0,3,0,6,a
gas jews,3,6,0,0,0,0,9,a
exclusive,2,0,3,0,1,0,6,a
matrix,1,0,0,0,1,1,3,a
barrel bomb,3,0,0,0,3,1,7,a
lefty,2,0,0,0,2,0,4,a
warriors,1,0,1,0,1,0,3,a
im,5,0,6,0,4,8,23,a
secretary of state tillerson,2,0,0,0,0,3,5,a
sean spicer video,2,2,0,0,0,0,4,a
trump news,1,0,0,0,1,1,3,a
knowγçö nazis used gas chambers,4,0,0,0,0,0,4,a
hitler gaffe causes uproar,2,0,0,0,0,2,4,a
fantastic,1,0,2,0,0,0,3,a
secretary,4,0,0,1,6,7,18,a
goonies,1,0,0,1,1,0,3,a
tfw alex jones,2,2,0,0,0,0,4,a
us eric trump,1,0,0,0,0,5,6,a
sean spicer raises eyebrows,2,2,0,0,0,0,4,a
revealed,9,0,0,0,5,8,22,a
commander in chief,6,0,0,0,6,0,12,a
how'd,1,0,1,0,1,0,3,a
bears,1,0,0,0,1,1,3,a
middle class,1,0,0,0,1,1,3,a
reddit,1,0,0,0,1,1,3,a
pos,1,0,0,9,4,5,19,a
male number one,1,2,0,0,0,0,3,a
deplorables,1,0,0,0,1,1,3,a
bet sean spicer,2,2,0,0,0,0,4,a
argues assad gassing worse,1,0,0,0,0,2,3,a
stars,2,0,0,0,2,0,4,a
teamsters,1,0,2,0,0,0,3,a
hill,7,0,0,0,5,1,13,a
neil,1,0,0,0,0,4,5,a
tops,1,0,1,0,1,2,5,a
lieu,1,0,0,0,1,1,3,a
crooks,3,0,0,0,2,0,5,a
passover seder,1,2,0,1,1,0,5,a
male,4,0,1,1,5,1,12,a
rally,3,0,1,0,2,0,6,a
hello,2,0,14,0,1,3,20,a
weγçöre,4,7,2,0,0,0,13,a
thegoodgodabove,1,0,3,0,0,0,4,a
sean spicer's clarification,1,1,0,0,0,3,5,a
sean spicer slammed,2,2,0,0,0,0,4,a
bbg,0,0,0,1,0,2,3,a
trump's syria strike,2,2,0,0,0,2,6,a
liberal media,2,1,0,0,1,0,4,a
secretary of state rex tillerson,5,0,0,0,0,0,5,a
gizmodo,1,0,2,0,0,1,4,a
medical,1,0,0,0,1,1,3,a
doesnγçöt,1,3,0,0,0,1,5,a
marketwatch,0,0,2,1,0,0,3,a
question of the day,3,0,0,0,1,0,4,a
comparing assad,1,3,0,0,0,1,5,a
uber,3,0,5,0,2,2,12,a
bother,1,0,0,1,1,0,3,a
solves,4,0,0,0,3,1,8,a
youre,1,0,0,1,1,0,3,a
sees sean spicer,3,3,0,0,0,0,6,a
sean spicer justifies syria strike,4,0,0,0,0,0,4,a
communicator of the year,2,0,0,0,1,0,3,a
judging,1,0,1,0,1,0,3,a
white house easter bunny,5,3,0,0,0,0,8,a
calls nepotism,2,0,0,0,2,0,4,a
meanwhile,3,0,15,0,2,2,22,a
jews on holocaust remembrance day,4,0,0,0,0,0,4,a
trump aide,5,15,0,0,1,3,24,a
united flights,1,2,0,0,0,0,3,a
western,6,0,2,0,5,0,13,a
translation,1,0,5,0,1,3,10,a
mall,2,0,0,0,2,0,4,a
give mediocre white men microphones,3,0,0,0,0,0,3,a
mike pence,2,1,0,0,1,0,4,a
russia prior,1,2,0,0,0,0,3,a
mention hitler,0,3,0,2,0,0,5,a
ffs,0,0,1,15,3,14,33,a
syria strikes,2,7,0,0,0,2,11,a
hitler comments,6,24,0,0,1,13,44,a
iγçöve,1,1,2,0,0,0,4,a
memo,1,0,0,0,1,2,4,a
mike,4,0,1,0,2,5,12,a
sean spicerγçös firing,4,6,0,0,0,0,10,a
north korea threatens,1,1,0,0,0,1,3,a
update,1,0,1,4,2,2,10,a
ba,0,0,0,1,0,2,3,a
man sean spicer,3,2,0,0,1,1,7,a
ap,0,0,0,3,1,1,5,a
boom,6,0,2,7,4,19,38,a
sean spicer meant,4,5,0,0,0,1,10,a
sean spicer's mental health grows,3,0,0,0,0,0,3,a
sean spicer grovels,2,2,0,0,0,0,4,a
sam,2,0,0,0,2,0,4,a
clickhole,2,0,1,0,1,0,4,a
sean spicer's history,1,2,0,0,0,0,3,a
chase,1,0,0,0,1,1,3,a
sean spicer credits hitler,4,0,0,0,0,4,8,a
wh easter bunny,2,3,0,0,0,0,5,a
constitutional,2,0,0,0,2,0,4,a
stock market,2,1,0,0,2,0,5,a
ellemagazine,1,0,2,0,0,0,3,a
gifs,2,0,0,0,1,2,5,a
peanuts,1,0,0,0,1,1,3,a
tower,3,0,0,0,2,0,5,a
ca,0,0,0,4,1,1,6,a
patience,2,0,0,0,2,0,4,a
satan,2,0,2,0,1,0,5,a
sean spicer show,2,3,0,0,0,1,6,a
spreading holocaust denial,2,2,0,0,0,3,7,a
polish death camps,0,0,0,1,0,2,3,a
spice,7,0,2,0,8,6,23,a
wmd,0,0,0,3,1,0,4,a
millions of americans,1,1,0,0,0,1,3,a
induced,1,0,0,0,1,1,3,a
nazi gas,1,2,0,0,0,0,3,a
sean spicer causes uproar,5,1,0,0,0,3,9,a
tiny,1,0,0,0,0,4,5,a
ah,4,0,12,2,1,7,26,a
6m,0,0,0,2,1,0,3,a
kabuki,2,0,1,0,1,0,4,a
issa,1,0,2,0,0,0,3,a
tarred,1,0,0,0,0,6,7,a
nastiest,0,0,0,4,1,0,5,a
eric trump may,2,3,0,0,0,2,7,a
ru,0,0,0,4,1,0,5,a
bull shit,1,1,0,1,1,0,4,a
holocaust center,64,40,0,1,25,20,150,a
ignorant sean spicer,1,2,0,0,0,0,3,a
americas,3,0,0,0,2,0,5,a
robbing,0,0,0,1,0,2,3,a
candidate,cap,substring-cap,s-o-sCap,all-cap,non-cap,non-discriminative,cumulative,status
says trump,3,5,0,0,0,1,9,a
meals on wheels,2,2,0,0,1,0,5,a
republican,12,0,4,0,7,6,29,a
nazi death camps,3,5,0,0,0,0,8,a
senator,2,0,0,0,2,1,5,a
senators,2,0,0,0,2,1,5,a
ww1,0,0,0,4,1,0,5,a
devil,3,0,0,0,2,0,5,a
syria strike proves,11,9,0,0,0,6,26,a
clearance,1,0,0,0,1,2,4,a
record,2,0,0,0,2,0,4,a
apparently hitler,1,2,0,0,0,0,3,a
adminstration,2,0,0,0,2,0,4,a
allied,1,0,0,0,1,1,3,a
bingo,3,0,0,0,3,0,6,a
thereγçös,1,2,1,0,0,0,4,a
hitler comparison,4,8,0,0,0,3,15,a
attack on syria,2,2,0,0,0,0,4,a
syria strike,18,49,0,0,0,6,73,a
united ceo oscar munoz,3,0,0,1,0,1,5,a
trump told,1,3,0,0,0,0,4,a
god,56,0,13,2,60,49,180,a
easter egg,0,1,0,0,0,5,6,a
whites,2,0,0,0,1,2,5,a
russia ties,11,29,0,0,1,7,48,a
sean spicer draws backlash,49,0,0,0,0,24,73,a
literally hitler,1,7,0,1,0,8,17,a
sob,1,0,0,2,2,1,6,a
press secretary sean spicer,48,11,0,0,0,9,68,a
measured,2,0,0,0,2,0,4,a
eric trump admits,4,4,0,0,0,2,10,a
bye bye,2,2,0,0,1,3,8,a
reaccomodated,2,0,0,0,2,0,4,a
pepsi ad,1,2,0,0,0,1,4,a
junior,3,0,2,0,2,1,8,a
cillizza,8,0,18,0,0,0,26,a
soldier,3,0,0,0,2,0,5,a
missile strike in syria,5,2,0,0,0,1,8,a
don the con,3,3,0,1,0,0,7,a
big win,1,0,0,0,1,3,5,a
daughter ivanka,2,3,0,0,0,4,9,a
pops,2,0,0,0,2,0,4,a
your fired,1,0,0,0,1,1,3,a
sean spicer's false claim,2,0,0,0,0,1,3,a
woah,1,0,1,0,0,3,5,a
obstruction,1,0,2,0,1,2,6,a
jesus,11,0,17,0,1,23,52,a
civil rights,1,0,0,0,1,1,3,a
welp,2,0,3,0,0,7,12,a
jr,12,0,1,1,8,2,24,a
watching sean spicer,8,14,0,0,1,1,24,a
eff,1,0,0,0,1,1,3,a
asshats,1,0,0,0,1,1,3,a
martin,1,0,2,0,0,0,3,a
white people,1,0,0,0,1,1,3,a
sean spicer barca,3,0,0,0,0,7,10,a
maga,0,0,0,7,3,2,12,a
defended hitler,1,3,0,0,0,12,16,a
god bless,2,3,0,0,0,1,6,a
swing,2,0,1,0,1,3,7,a
leftists,7,0,5,0,5,10,27,a
opposition,2,0,0,0,2,2,6,a
employment,2,0,0,0,2,1,5,a
jewish holiday,1,3,0,0,0,1,5,a
hitler comment,19,32,0,1,0,14,66,a
yesterday pepsi,1,3,0,0,0,0,4,a
billion,11,0,0,1,9,0,21,a
fire spicer,6,7,0,0,1,3,17,a
sean spicer apologizes,27,46,0,0,0,27,100,a
make america great again,3,2,0,1,0,0,6,a
progressives,2,0,1,0,2,0,5,a
ww3,0,0,0,19,8,0,27,a
defending hitler on passover,2,1,0,0,0,2,5,a
amen,1,0,0,1,2,5,9,a
drumpf,6,0,0,0,6,0,12,a
corp,1,0,0,0,1,1,3,a
pants on fire,4,1,0,0,3,1,9,a
politifact,1,0,2,0,0,0,3,a
top 5,0,1,0,0,1,15,17,a
university,2,0,0,0,1,3,6,a
legal fisa,1,2,0,1,0,0,4,a
wh press secretary,5,8,0,0,0,1,14,a
goy,0,0,0,3,1,1,5,a
fbi fisa warrant,1,1,0,1,0,7,10,a
protecting,0,0,2,1,0,1,4,a
sister influenced presidentγçös decision,4,0,0,0,0,2,6,a
tfw,0,0,1,1,0,1,3,a
sale,1,0,0,0,1,2,4,a
pop,1,0,0,0,1,1,3,a
holocaust centre,6,4,0,0,4,3,17,a
holocaust gaffe,3,5,0,0,0,0,8,a
obama admin,1,3,0,0,0,1,5,a
impeach trump,1,2,0,0,0,1,4,a
jeff sessions lied,0,0,0,4,0,0,4,a
bullshit stunt,1,1,0,0,0,2,4,a
american government,1,2,0,0,0,0,3,a
potato,2,0,0,0,2,0,4,a
flash,2,0,1,0,2,1,6,a
hitler remarks at press briefing,3,0,0,0,0,0,3,a
praises hitler,1,3,0,0,0,0,4,a
seder,10,0,0,0,9,1,20,a
feathered,1,0,0,0,0,6,7,a
sean spicer proves,2,2,0,0,0,0,4,a
say eric,1,2,0,0,0,0,3,a
tv,2,0,0,42,11,2,57,a
holo,1,0,0,0,1,1,3,a
objectivity,1,0,1,0,1,4,7,a
replace spicer,2,3,0,0,0,0,5,a
receipts,0,0,0,2,1,0,3,a
russian spy,3,9,0,1,0,2,15,a
scholar lawprof,1,0,0,0,0,6,7,a
heγçös,2,7,0,0,0,0,9,a
generals,6,0,0,0,4,2,12,a
carter page met,1,2,0,0,0,1,4,a
obviously sean spicer,2,2,0,0,0,0,4,a
sean spicer falsely stated,1,0,0,0,0,2,3,a
white house press briefing,8,5,0,0,0,4,17,a
holocaust centers sean spicer,3,0,0,0,0,3,6,a
spent,4,0,1,0,4,0,9,a
disabled germans,1,2,0,0,0,0,3,a
fire trump,1,3,0,0,0,1,5,a
social studies,1,0,0,0,1,1,3,a
sean spicer went on cnn,3,0,0,0,0,0,3,a
jim,2,0,0,0,1,3,6,a
tucker,1,0,0,0,1,1,3,a
whoops,1,0,2,0,0,0,3,a
making america,2,3,0,0,0,0,5,a
sa,0,0,0,4,1,0,5,a
jews gassed,1,2,0,0,0,0,3,a
really sean spicer,1,1,0,0,0,3,5,a
meet in moscow on weekend,3,0,0,0,0,0,3,a
us government,1,2,0,0,0,0,3,a
safe zones,1,0,0,0,1,1,3,a
save sean spicer,2,2,0,0,0,2,6,a
bff,0,0,0,2,1,0,3,a
anne frank center calling,2,1,0,0,0,0,3,a
says ivanka,1,2,0,0,0,0,3,a
bannon in the white house,3,0,0,0,0,0,3,a
breaking,5,0,10,43,19,22,99,a
trumprussia,4,1,1,0,2,1,9,a
wag the dog,3,0,0,0,3,3,9,a
fo,0,0,0,2,1,0,3,a
stooges,2,0,0,0,2,0,4,a
court jester,3,0,0,0,3,0,6,a
gas jews,3,6,0,0,0,0,9,a
exclusive,2,0,3,0,1,0,6,a
matrix,1,0,0,0,1,1,3,a
barrel bomb,3,0,0,0,3,1,7,a
lefty,2,0,0,0,2,0,4,a
im,5,0,6,0,4,8,23,a
secretary of state tillerson,2,0,0,0,0,3,5,a
sean spicer video,2,2,0,0,0,0,4,a
trump news,1,0,0,0,1,1,3,a
knowγçö nazis used gas chambers,4,0,0,0,0,0,4,a
hitler gaffe causes uproar,2,0,0,0,0,2,4,a
fantastic,1,0,2,0,0,0,3,a
goonies,1,0,0,1,1,0,3,a
tfw alex jones,2,2,0,0,0,0,4,a
us eric trump,1,0,0,0,0,5,6,a
revealed,9,0,0,0,5,8,22,a
commander in chief,6,0,0,0,6,0,12,a
bears,1,0,0,0,1,1,3,a
middle class,1,0,0,0,1,1,3,a
reddit,1,0,0,0,1,1,3,a
pos,1,0,0,9,4,5,19,a
deplorables,1,0,0,0,1,1,3,a
bet sean spicer,2,2,0,0,0,0,4,a
argues assad gassing worse,1,0,0,0,0,2,3,a
stars,2,0,0,0,2,0,4,a
teamsters,1,0,2,0,0,0,3,a
hill,7,0,0,0,5,1,13,a
neil,1,0,0,0,0,4,5,a
tops,1,0,1,0,1,2,5,a
lieu,1,0,0,0,1,1,3,a
crooks,3,0,0,0,2,0,5,a
passover seder,1,2,0,1,1,0,5,a
weγçöre,4,7,2,0,0,0,13,a
thegoodgodabove,1,0,3,0,0,0,4,a
sean spicer's clarification,1,1,0,0,0,3,5,a
sean spicer slammed,2,2,0,0,0,0,4,a
bbg,0,0,0,1,0,2,3,a
trump's syria strike,2,2,0,0,0,2,6,a
liberal media,2,1,0,0,1,0,4,a
secretary of state rex tillerson,5,0,0,0,0,0,5,a
gizmodo,1,0,2,0,0,1,4,a
medical,1,0,0,0,1,1,3,a
doesnγçöt,1,3,0,0,0,1,5,a
marketwatch,0,0,2,1,0,0,3,a
question of the day,3,0,0,0,1,0,4,a
comparing assad,1,3,0,0,0,1,5,a
uber,3,0,5,0,2,2,12,a
bother,1,0,0,1,1,0,3,a
solves,4,0,0,0,3,1,8,a
youre,1,0,0,1,1,0,3,a
sees sean spicer,3,3,0,0,0,0,6,a
sean spicer justifies syria strike,4,0,0,0,0,0,4,a
communicator of the year,2,0,0,0,1,0,3,a
white house easter bunny,5,3,0,0,0,0,8,a
calls nepotism,2,0,0,0,2,0,4,a
jews on holocaust remembrance day,4,0,0,0,0,0,4,a
trump aide,5,15,0,0,1,3,24,a
united flights,1,2,0,0,0,0,3,a
western,6,0,2,0,5,0,13,a
mall,2,0,0,0,2,0,4,a
give mediocre white men microphones,3,0,0,0,0,0,3,a
mike pence,2,1,0,0,1,0,4,a
russia prior,1,2,0,0,0,0,3,a
ffs,0,0,1,15,3,14,33,a
syria strikes,2,7,0,0,0,2,11,a
hitler comments,6,24,0,0,0,13,43,a
iγçöve,1,1,2,0,0,0,4,a
memo,1,0,0,0,1,2,4,a
mike,4,0,1,0,2,5,12,a
sean spicerγçös firing,4,6,0,0,0,0,10,a
north korea threatens,1,1,0,0,0,1,3,a
update,1,0,1,4,2,2,10,a
ba,0,0,0,1,0,2,3,a
man sean spicer,3,2,0,0,1,1,7,a
ap,0,0,0,3,1,1,5,a
boom,6,0,2,7,4,19,38,a
sean spicer meant,4,5,0,0,0,1,10,a
sean spicer's mental health grows,3,0,0,0,0,0,3,a
sean spicer grovels,2,2,0,0,0,0,4,a
sam,2,0,0,0,2,0,4,a
clickhole,2,0,1,0,1,0,4,a
pt,1,0,0,0,1,6,8,a
chase,1,0,0,0,1,1,3,a
sean spicer credits hitler,4,0,0,0,0,4,8,a
wh easter bunny,2,3,0,0,0,0,5,a
constitutional,2,0,0,0,2,0,4,a
stock market,2,1,0,0,2,0,5,a
ellemagazine,1,0,2,0,0,0,3,a
gifs,2,0,0,0,1,2,5,a
peanuts,1,0,0,0,1,1,3,a
tower,3,0,0,0,2,0,5,a
ca,0,0,0,4,1,1,6,a
patience,2,0,0,0,2,0,4,a
satan,2,0,2,0,1,0,5,a
sean spicer show,2,3,0,0,0,1,6,a
spreading holocaust denial,2,2,0,0,0,3,7,a
polish death camps,0,0,0,1,0,2,3,a
wmd,0,0,0,3,1,0,4,a
millions of americans,1,1,0,0,0,1,3,a
nazi gas,1,2,0,0,0,0,3,a
sean spicer causes uproar,5,1,0,0,0,3,9,a
ah,4,0,12,2,1,7,26,a
6m,0,0,0,2,1,0,3,a
kabuki,2,0,1,0,1,0,4,a
issa,1,0,2,0,0,0,3,a
tarred,1,0,0,0,0,6,7,a
nastiest,0,0,0,4,1,0,5,a
eric trump may,2,3,0,0,0,1,6,a
ru,0,0,0,4,1,0,5,a
bull shit,1,1,0,1,1,0,4,a
americas,3,0,0,0,2,0,5,a
robbing,0,0,0,1,0,2,3,a
